Title,Domestic_Gross,International_Gross,Worldwide_Gross,Opening_Gross,Number_of_Opening_Theaters
Avatar,749766139,1994570654,2744336793,77025481,3452
Toy Story 3,415004880,651964823,1066969703,110307189,4028
Alice in Wonderland,334191110,691276000,1025467110,116101023,3728
Iron Man 2,312433331,311500000,623933331,128122480,4380
The Twilight Saga: Eclipse,300531751,397959596,698491347,64832191,4468
Inception,292576195,535745837,828322032,62785337,3792
Harry Potter and the Deathly Hallows: Part 1,295983305,680553613,976536918,125017372,4125
Despicable Me,251513985,291600000,543113985,56397125,3476
Shrek Forever After,238736787,513864080,752600867,70838207,4359
How to Train Your Dragon,217581231,277297528,494878759,43732319,4055
The Karate Kid,176591618,182534404,359126022,55665805,3663
Clash of the Titans,163214888,330000105,493214993,61235105,3777
Grown Ups,162001186,109429003,271430189,40506562,3534
Tangled,200821936,391639796,592461732,48767052,3603
Megamind,148415853,173469912,321885765,46016833,3944
The Last Airbender,131772187,187941694,319713881,40325019,3169
Shutter Island,128012934,166791261,294804195,41062440,2991
The Other Guys,119219978,51238944,170458922,35543162,3651
Salt,118311368,175191986,293503354,36011243,3612
TRON: Legacy,172062763,228000000,400062763,44026211,3451
Jackass 3D,117229692,54456100,171685792,50353641,3081
Valentine's Day,110485654,106000000,216485654,56260707,3665
Sherlock Holmes,209028679,315000000,524028679,62304277,3626
Robin Hood,105269730,216400011,321669741,36063385,3503
The Expendables,103068524,171401870,274470394,34825135,3270
Due Date,100539043,111241781,211780824,32689406,3355
Alvin and the Chipmunks: The Squeakquel,219614612,223525393,443140005,48875415,3700
Date Night,98711404,53552476,152263880,25207599,3374
Sex and the City 2,95347692,195397363,290745055,31001870,3445
The Book of Eli,94835059,62272696,157107755,32789494,3111
The Social Network,96962694,127957621,224920315,22445653,2771
The Town,92186262,61839874,154026136,23808032,2861
Prince of Persia: The Sands of Time,90759676,245606000,336365676,30095259,3646
RED,90380162,108626225,199006387,21761408,3255
Percy Jackson & the Olympians: The Lightning Thief,88768303,137728906,226497209,31236067,3356
Paranormal Activity 2,84752907,92759125,177512032,40678424,3216
Little Fockers,148438600,162211985,310650585,30833665,3536
Eat Pray Love,80574010,124020006,204594016,23104523,3082
The Chronicles of Narnia: The Voyage of the Dawn Treader,104386950,311299267,415686217,24005069,3555
Dear John,80014842,34969824,114984666,30468614,2969
Unstoppable,81562942,86242524,167805466,22688457,3207
The A-Team,77222099,100016697,177238796,25669455,3535
Knight and Day,76423035,185507401,261930436,20139985,3098
Dinner for Schmucks,73026337,13829402,86855739,23527839,2911
It's Complicated,112735375,106368280,219103655,22100820,2887
True Grit,171243005,81033922,252276927,24830443,3047
The Bounty Hunter,67061228,69272294,136333522,20686423,3074
Diary of a Wimpy Kid,64003625,12192913,76196538,22126166,3077
The Sorcerer's Apprentice,63150991,152132751,215283742,17619622,3504
A Nightmare on Elm Street,63075011,52619852,115694863,32902299,3332
The Last Song,62950384,26186663,89137047,16007426,2673
The Wolfman,61979680,77810085,139789765,31479235,3222
Get Him to the Greek,60974475,30745780,91720255,17570955,2697
Resident Evil: Afterlife,60128566,240099518,300228084,26650264,3203
Why Did I Get Married Too?,60095852,578120,60673972,29289537,2155
Tooth Fairy,60022256,52440252,112462508,14010409,3344
The Blind Side,255959475,53248834,309208309,34119372,3110
Secretariat,59713955,607906,60321861,12694770,3072
Easy A,58401464,16624752,75026216,17734040,2856
Takers,57744720,11310975,69055695,20512304,2206
Yogi Bear,100246011,103264186,203510197,16411322,3515
Legend of the Guardians: The Owls of Ga'Hoole,55675313,84398077,140073390,16112211,3575
Letters to Juliet,53032453,26260991,79293444,13540486,2968
Life as We Know It,53374681,52359735,105734416,14506464,3150
Wall Street: Money Never Sleeps,52474616,82273405,134748021,19011188,3565
Predators,52000688,75232420,127233108,24760882,2669
Hot Tub Time Machine,50287556,14448196,64735752,14020502,2754
Up in the Air,83823381,83019358,166842739,1181450,15
The Tourist,67631157,211149284,278780441,16472458,2756
Kick-Ass,48071303,48117600,96188903,19828687,3065
Killers,47059963,51100000,98159963,15837266,2859
Saw: The Final Chapter,45710178,90440256,136150434,22530123,2808
Cop Out,44875481,10735520,55611001,18211126,3150
The Lovely Bones,44114232,49507108,93621340,116616,3
Cats & Dogs: The Revenge of Kitty Galore,43585753,68898011,112483764,12279363,3705
Edge of Darkness,43313890,37812632,81126522,17214384,3066
Death at a Funeral,42739347,6311539,49050886,16217540,2459
Step Up 3D,42400223,116891586,159291809,15812311,2435
The Last Exorcism,41034350,28398177,69432527,20366613,2874
Black Swan,106954678,222443368,329398046,1443809,18
Legion,40168080,27750578,67918658,17501625,2476
The Crazies,39123589,15683234,54806823,16067552,2476
The Fighter,93617009,35573860,129190869,300010,4
Crazy Heart,39464306,7941260,47405566,82664,4
For Colored Girls,37729698,252286,37981984,19497324,2127
The Back-up Plan,37490007,39987001,77477008,12201710,3280
Burlesque,39440655,50079118,89519773,11947744,3037
Vampires Suck,36661504,43886362,80547866,12202831,3233
The American,35606376,32269905,67876281,13177790,2823
Green Zone,35053660,59828889,94882549,14309295,3003
Marmaduke,33644788,50117056,83761844,11599661,3213
Devil,33601190,29094299,62695489,12289375,2809
Hereafter,32746941,74209389,106956330,220322,6
When in Rome,32680633,10372743,43053376,12350041,2456
She's Out of My League,32010860,17768868,49779728,9775278,2956
Scott Pilgrim vs. the World,31524275,16140284,47664559,10609795,2818
Charlie St. Cloud,31162545,17028159,48190704,12381585,2718
Love & Other Drugs,32367005,70453003,102820008,9739161,2455
Morning Glory,31011732,29029244,60040976,9203266,2518
Daybreakers,30101577,21314887,51416464,15146692,2523
Nanny McPhee Returns,29011215,64239906,93251121,8407685,2784
The Princess and the Frog,104400899,162644866,267045765,786190,2
The Switch,27779426,22051181,49830607,8436713,2012
Brooklyn's Finest,27163593,9276608,36440201,13350299,1936
Machete,26593646,18898010,45491656,11416164,2670
Ramona and Beezus,26167002,1126741,27293743,7810481,2719
Leap Year,25918920,6767580,32686500,9202815,2511
You Again,25702053,6352316,32054369,8407513,2548
Alpha and Omega,25107267,25400000,50507267,9106906,2625
Piranha 3D,25003155,58185010,83188165,10106872,2470
Lottery Ticket,24719879,0,24719879,10652297,1973
The Spy Next Door,24307086,20929457,45236543,9726056,2924
From Paris with Love,24077427,28753524,52830951,8158860,2722
The Losers,23591432,5806222,29397654,9406348,2936
Faster,23240020,12386938,35626958,8523153,2454
How Do You Know,30212620,18456287,48668907,7484696,2483
Just Wright,21540363,44061,21584424,8284989,1831
Skyline,21393620,45591267,66984887,11692415,2880
Gulliver's Travels,42779261,194603463,237382724,6307691,2546
The Next Three Days,21148651,46300000,67448651,6542779,2564
The Kids Are All Right,20811365,13894485,34705850,491971,7
Our Family Wedding,20255281,1153747,21409028,7629862,1605
Hubble 3D,52522904,21726825,74249729,413477,39
Oceans,19422319,63229120,82651439,6058958,1206
Remember Me,19068240,36964649,56032889,8089139,2212
Going the Distance,17804299,24254812,42059111,6884964,3030
The King's Speech,135453143,288545959,423999102,355450,4
Furry Vengeance,17630465,18657667,36288132,6627564,2997
Splice,17010170,10117450,27127620,7385277,2450
The Ghost Writer,15541549,44789898,60331447,183009,4
Youth in Revolt,15281286,4369807,19651093,6888334,1873
My Soul to Take,14744435,6756378,21500813,6842220,2572
Repo Men,13794835,4615056,18409891,6126170,2521
Case 39,13261851,14928752,28190603,5350570,2211
Let Me In,12134935,14958657,27093592,5147479,2020
The Twilight Saga: New Moon,296623634,413203828,709827462,142839137,4024
Extraordinary Measures,12068313,3065980,15134293,6012594,2549
Invictus,37491364,84742607,122233971,8611147,2125
Avatar,10741486,35082008,45823494,4007750,812
Jonah Hex,10547117,356195,10903312,5379365,2825
127 Hours,18335230,42403567,60738797,264851,4
The Girl with the Dragon Tattoo,10095170,94319030,104414200,335502,34
Nine,19676965,34327985,54004950,257232,4
Did You Hear About the Morgans?,29580087,55700163,85280250,6616571,2718
Get Low,9176933,1345578,10522511,88182,4
Fair Game,9540691,16258224,25798915,651082,46
The Young Victoria,11001272,18180557,29181829,260591,44
MacGruber,8525600,797295,9322895,4043495,2551
A Single Man,9176000,15788890,24964890,217332,9
The Girl Who Played with Fire,7638241,59514984,67153225,904998,108
Cyrus,7468936,2464937,9933873,181716,4
Babies,7320323,2898983,10219306,2160460,534
The Imaginarium of Doctor Parnassus,7689607,54119168,61808775,415233,48
Conviction,6783129,4321426,11104555,102351,11
City Island,6671036,1207820,7878856,32001,2
The Last Station,6617867,6932905,13550772,73723,3
Waiting for 'Superman',6417135,16553,6433688,139033,4
The Secret in Their Eyes,6391436,27573843,33965279,167866,10
It's Kind of a Funny Story,6363628,127612,6491240,2013406,742
Winter's Bone,6531503,7265331,13796834,84797,4
Under the Sea 3D,36262926,19639698,55902624,661185,49
The Warrior's Way,5666340,5437094,11103434,3048665,1622
I Am Love,5005465,7009198,12014663,121504,8
Precious,47566524,16083005,63649529,1872458,18
The Girl Who Kicked the Hornet's Nest,5190196,39086139,44276335,881737,154
An Education,12574914,13521938,26096852,159017,4
Mao's Last Dancer,4817770,19096961,23914731,199657,33
Solitary Man,4360548,1254842,5615390,94936,4
Greenberg,4234170,2109942,6344112,118152,3
Please Give,4033574,280255,4313829,118123,5
My Name Is Khan,4018771,38326589,42345360,1944027,120
To Save a Life,3777210,47658,3824868,1581517,441
2012,166112167,603567306,769679473,65237614,3404
The Runaways,3573673,1107978,4681651,805115,244
Broken Embraces,5014305,32458202,37472507,107111,2
Inside Job,4312735,3558787,7871522,39649,2
Lebanon,368088,852288,1220376,17145,2
Exit Through the Gift Shop,3291250,2094992,5386242,170756,8
3 Idiots,6532874,53729962,60262836,1645502,119
Catfish,3237343,296368,3533711,257285,12
You Will Meet a Tall Dark Stranger,3248246,32619076,35867322,160103,6
Chloe,3075255,8733625,11808880,900688,350
Old Dogs,49492060,47261636,96753696,16894511,3425
Joan Rivers: A Piece of Work,2930687,0,2930687,164351,7
Letters to God,2848578,60315,2908893,1088873,897
Planet 51,42194060,63453042,105647102,12286129,3035
The Hurt Locker,17017811,32212961,49230772,145352,4
N-Secure,2595644,0,2595644,1166406,486
Magnificent Desolation: Walking on the Moon 3D,34137524,6201878,40339402,479587,80
Never Let Me Go,2434652,7470143,9904795,111734,4
Twilight/The Twilight Saga: New Moon,2385237,26473609,28858846,0,0
Fantastic Mr. Fox,21002919,25468104,46471023,265900,4
Brothers,28544157,14930421,43474578,9527848,2088
The White Ribbon,2222862,17096809,19319671,59848,3
A Prophet,2087720,15786324,17874044,163773,9
Tamara Drewe,560391,11477582,12037973,18604,4
Harry Brown,1818681,8552770,10371451,173353,19
Stone,1810078,8490338,10300416,75766,6
The Road,8117000,19522579,27639579,1502231,111
Flipped,1755212,0,1755212,224233,45
Kites,1643486,1281265,2924751,959329,207
Coco Chanel & Igor Stravinsky,1621226,4304069,5925295,44454,3
Cairo Time,1603616,873699,2477315,66245,5
Space Station 3D,93383953,34979928,128363881,489488,24
Politics,1514558,11089666,12604224,850244,124
The Joneses,1475746,5555983,7031729,509689,193
Nowhere Boy,1457248,5120531,6577779,52749,4
Restrepo,1330894,105497,1436391,35581,2
Fearless,1288549,1654005,2942554,628137,62
Micmacs,1262079,4205812,5467891,42751,4
Housefull,1183658,1156892,2340550,642156,82
Hotchpotch 3,1132192,935479,2067671,626432,86
Mother and Child,1110509,4511462,5621971,43040,4
Deep Sea,46412757,51818148,98230905,700213,43
La Mission,1062941,0,1062941,49046,15
Buried,1044143,18395621,19439764,100268,11
The Perfect Game,1037071,2841922,3878993,511698,417
The Oscar Nominated Short Films 2010: Live Action,1018169,0,1018169,291360,95
Guzaarish,1017335,1026245,2043580,488121,108
Animal Kingdom,1044039,6164192,7208231,61968,7
I Love You Phillip Morris,2037459,18685384,20722843,112520,6
A Christmas Carol,137855863,187430783,325286646,30051075,3683
Cloudy with a Chance of Meatballs,124870275,118135851,243006126,30304648,3119
Tees Maar Khan,1076443,1377971,2454414,539793,108
Where the Wild Things Are,77233467,22906629,100140096,32695407,3735
Couples Retreat,109204945,62639895,171844840,34286740,3000
Princess Kaiulani,883887,0,883887,186995,33
Anjaana Anjaani,854757,761131,1615888,517608,91
I Hate Luv Storys,847993,14871219,15719212,375297,85
Ninja Assassin,38122883,23478397,61601280,13316158,2503
The Tillman Story,802535,0,802535,52185,4
Sea Monsters: A Prehistoric Adventure,23746066,26906397,50652463,605722,252
What If...,814906,0,814906,49770,23
Peepli [Live],757951,8702980,9460931,350054,64
Middle Men,754301,0,754301,325641,252
North Face,711421,6103635,6815056,23050,4
Raavan,708726,647735,1356461,482760,120
The Wildest Dream,898137,0,898137,67848,12
The Secret of Kells,676775,1126637,1803412,39826,1
Mid-August Lunch,675299,8845634,9520933,13090,2
The Polar Express,672796,1125478,1798274,80505,15
The Concert,657986,40488365,41146351,21742,2
We Are Family,638144,392926,1031070,296907,78
The Virginity Hit,636706,0,636706,301885,700
Ajami,622403,709248,1331651,35792,3
Agora,619423,38837919,39457342,33262,2
Vincere,619162,5082319,5701481,18096,2
Law Abiding Citizen,73357727,54586481,127944208,21039502,2890
Howl,617334,661056,1278390,51185,6
Mother,551509,16597839,17149348,35858,6
Ondine,550472,1226547,1777019,27497,5
The Art of the Steal,544890,0,544890,39019,3
Jack Goes Boating,541992,95487,637479,28916,4
Khatta Meetha,541904,498910,1040814,309211,83
Mesrine Part 1: Killer Instinct,551697,21093,572790,152873,28
Standing Ovation,531806,0,531806,343125,623
Mademoiselle Chambon,531685,4979686,5511371,19446,2
Metropolis,529603,0,529603,19978,2
The Man from Nowhere,528175,44195057,44723232,35751,1
Brave,527193,334437,861630,334562,92
Preacher's Kid,515065,0,515065,190638,109
Heartbreaker,504030,10102341,10606371,52628,3
The City of Your Final Destination,493296,951105,1444401,24401,1
The Salvation Poem,914818,182932,1097750,0,0
Armored,15988876,6953345,22942221,6511128,1915
The Messenger,1109660,485757,1595417,44523,4
Dolphins and Whales 3D: Tribes of the Ocean,7714996,1093663,8808659,41695,4
The Most Dangerous Man in America: Daniel Ellsberg and the Pentagon Papers,453993,0,453993,1114,1
The Extra Man,453377,196249,649626,18861,2
The Men Who Stare at Goats,32428195,36667576,69095771,12706654,2443
I Want Your Money,433588,0,433588,249428,537
The Boondock Saints II: All Saints Day,10273188,356133,10629321,546687,68
Break Ke Baad,427628,389360,816988,194737,85
Made in Dagenham,1095369,11534102,12629471,37563,3
I'm Still Here,408983,217413,626396,96658,19
The Square,406116,0,406116,17092,2
Wild Grass,403952,4422138,4826090,39162,5
Fish Tank,374675,2029625,2404300,25854,2
Grease,365802,0,365802,60759,12
Breathless,363031,0,363031,32424,4
Like Dandelion Dust,352810,0,352810,77960,25
Creation,341323,1717352,2058675,53073,7
Me and Orson Welles,1190003,1146169,2336172,63638,4
Enter the Void,336467,438918,775385,43651,3
Rabbit Hole,2229058,2911867,5140925,53778,5
Somewhere,1785645,13002997,14788642,119086,7
A Film Unfinished,320486,0,320486,34060,4
The Yellow Handkerchief,318623,0,318623,37296,7
Today's Special,317831,0,317831,90639,55
Vision,435274,4608604,5043878,11406,1
Bad Lieutenant: Port of Call New Orleans,1702112,8891816,10593928,245398,27
Holy Rollers,303064,441202,744266,39685,3
The Little Traitor,402088,52393,454481,2330,1
All Good Things,582024,1107622,1689646,37172,2
If You Are the One 2,426894,75658549,76085443,182517,20
Karthik Calling Karthik,286409,7090,293499,179643,70
Last Train Home,288328,0,288328,20418,1
No Problem,285468,368901,654369,242116,84
Life During Wartime,281447,501785,783232,30507,1
Soul Kitchen,276901,17887238,18164139,20916,2
Tiny Furniture,391674,0,391674,21235,1
Countdown to Zero,272040,15671,287711,41307,3
Mesrine Part 2: Public Enemy #1,275387,16763,292150,74449,31
Kings of Pastry,336386,0,336386,15162,2
Jean-Michel Basquiat: The Radiant Child,256242,0,256242,17466,1
Frozen,246176,3597598,3843774,131395,106
When You're Strange,246078,948104,1194182,66833,8
White Material,304020,1088414,1392434,34613,3
Monsters,237301,4823137,5060438,20508,3
Four Lions,304616,5844071,6148687,41512,8
That Evening Sun,281350,0,281350,7330,1
Formosa Betrayed,225341,100693,326034,77326,15
The Black Waters of Echo's Pond,224409,0,224409,224409,404
The Tempest,277943,127918,405861,42436,5
The Killer Inside Me,217277,3832863,4050140,11083,1
La soga,210625,0,210625,52554,11
The Girl on the Train,208023,1428556,1636579,19154,2
Sweetgrass,207473,0,207473,9870,1
Legendary,200393,0,200393,126964,177
Rare Exports,236347,3792624,4028971,9281,1
South of the Border,198600,85614,284214,21545,1
The Nutcracker in 3D,195459,16723487,16918946,65944,42
House,209765,0,209765,12032,1
Iron Man,318604126,266762121,585366247,98618668,4105
"A Woman, a Gun and a Noodle Shop",190946,237303,428249,27330,5
Nick Saban: Gamechanger,189000,0,189000,188786,26
The Secrets of Jonathan Sperry,1355079,0,1355079,258400,117
Twelve,183920,2464275,2648195,110238,231
The Human Centipede (First Sequence),181467,70740,252207,12424,1
Winnebago Man,181039,0,181039,16469,2
Casino Jack and the United States of Money,176865,0,176865,28234,9
71: Into the Fire,176638,20791022,20967660,77161,20
Partir,176113,7379921,7556034,12697,2
Astro Boy,19551067,20335919,39886986,6702923,3014
La Danse: The Paris Opera Ballet,567493,557345,1124838,14000,1
Terribly Happy,170943,2658041,2828984,11650,1
Casino Jack,1042959,166750,1209709,34528,7
Client 9: The Rise and Fall of Eliot Spitzer,189416,3454,192870,16962,3
Chance Pe Dance,168643,51976,220619,117917,68
The Disappearance of Alice Creed,166980,729939,896919,40258,10
Fool for Love,165987,0,165987,49313,8
Genius Within: The Inner Life of Glenn Gould,167508,0,167508,17034,3
Welcome to the Rileys,158898,199116,358014,42145,10
Red Riding: The Year of Our Lord 1974,151644,0,151644,14526,1
A Town Called Panic,165509,340190,505699,2850,1
Only the Brave,150000,0,150000,14825,5
My Dog Tulip,246574,0,246574,11550,1
U2 3D,10363341,12367501,22730842,946000,61
Father of My Children,144022,336812,480834,10414,1
The Cremaster Cycle,151239,0,151239,7982,1
Blue Valentine,9706328,5186090,14892418,193728,4
The Weathered Underground,140091,0,140091,1010,3
Chain Letter,138788,716397,855185,138788,406
Love Ranch,137885,0,137885,44220,11
Coco Before Chanel,6113834,44699100,50812934,406768,43
Carlos,145526,913843,1059369,20006,2
The Eclipse,133411,26441,159852,13207,6
A Serious Man,9228768,22201566,31430334,251337,6
The Warlords,129078,42754103,42883181,10073,3
The Good the Bad the Weird,128486,44132723,44261209,4775,1
Stonewall Uprising,128203,0,128203,15729,4
"Lovely, Still",127564,151606,279170,4584,2
Paranormal Activity,107918810,85436990,193355800,77873,12
Ran,124673,0,124673,10245,2
Red Cliff,627047,129081386,129708433,13104,2
Centurion,123570,6766862,6890432,42826,12
Valley of the Heart's Delight,119290,0,119290,5164,4
Touching Home,116353,0,116353,47382,3
The Greatest,114766,870415,985181,33616,8
Bran Nue Dae,113568,6698962,6812530,23527,16
Let's Talk About the Rain,111844,10022522,10134366,16290,2
Best Worst Movie,109895,0,109895,5503,1
Blood Done Sign My Name,109383,0,109383,82739,95
After.Life,108595,2314039,2422634,59946,41
Wild Target,108589,3385565,3494154,23174,4
Inspector Bellamy,107612,3574042,3681654,20635,2
See What I'm Saying: The Deaf Entertainers Documentary,118206,0,118206,4996,1
The Romantics,106524,84495,191019,45527,2
Galapagos,18630372,10718800,29349172,0,0
Saint John of Las Vegas,102645,9086,111731,21666,2
Everyone Else,102042,2532420,2634462,10810,1
Survival of the Dead,101740,41451,143191,43757,20
Waste Land,187716,103591,291307,9806,1
Freakonomics,101270,16408,117678,31893,20
The Good Guy,100688,0,100688,34712,9
8: The Mormon Proposition,100280,0,100280,42566,16
Kings of the Evening,99270,0,99270,11156,4
I Spit on Your Grave,93051,1185599,1278650,32440,12
The Maid,576608,1070947,1647555,17036,1
Country Strong,20218921,310273,20529194,30452,2
OSS 117: Lost in Rio,89375,21834870,21924245,10243,3
The Fourth Kind,25486040,22223153,47709193,12231160,2527
Crazy on the Outside,88335,0,88335,64438,75
The Cartel,87763,0,87763,3694,2
The Illusionist,2231474,3775720,6007194,38594,3
Until the Light Takes Us,130441,0,130441,7246,1
The Private Lives of Pippa Lee,337356,2523617,2860973,89950,12
Feed the Fish,101170,0,101170,5820,1
No One Knows About Persian Cats,81768,798169,879937,8843,2
Kisses,81680,15253,96933,15485,2
Waking Sleeping Beauty,80741,4177,84918,33115,5
Breaking Upwards,77389,0,77389,15467,1
Another Year,3205706,16517060,19722766,111869,6
Prodigal Sons,73544,0,73544,6102,1
Dogtooth,110248,302480,412728,6686,2
The Sicilian Girl,71239,0,71239,5922,1
Rosencrantz and Guildenstern Are Undead,71007,0,71007,14370,2
Leaves of Grass,70066,948687,1018753,20987,3
Pirate Radio,8017917,28330867,36348784,2904380,882
2012: Time for Change,68339,0,68339,9009,1
Budrus,68353,0,68353,7819,1
John Rabe,67519,1417146,1484665,4892,3
The Sun Behind the Clouds: Tibet's Struggle for Freedom,67095,0,67095,10884,1
Dancing Across Borders,66166,0,66166,5204,1
Racing Dreams,65082,0,65082,20048,33
Marwencol,112036,0,112036,3276,1
Killing Kasztner,112313,0,112313,5513,1
Cool It,62713,0,62713,26847,41
Aftershock,62962,100230311,100293273,19329,25
Orlando,58198,0,58198,10885,2
"Patrik, Age 1.5",57468,3201600,3259068,408,1
Looking for Eric,55804,11506435,11562239,6743,2
Alamar,61613,241961,303574,7668,1
Le Amiche,68167,0,68167,10092,1
The Nature of Existence,54645,0,54645,2977,1
The Lottery,54543,0,54543,16435,1
The Harimaya Bridge,54473,0,54473,1226,1
Strange Powers: Stephin Merritt and the Magnetic Fields,68719,0,68719,4620,1
Harlan: In the Shadow of Jew Suess,54305,0,54305,9258,1
God of Vampires,53345,0,53345,10395,10
Hatchet II,52604,103586,156190,52604,68
Cropsey,52476,0,52476,6306,1
Breath Made Visible: Anna Halprin,52387,0,52387,8425,3
The Human Experience,52296,0,52296,27170,5
Night Catches Us,76185,0,76185,13562,4
Undertow,108620,493439,602059,6749,1
Tales from Earthsea,48658,0,48658,20614,5
Enemies of the People,73171,7483,80654,2277,1
Change of Plans,46714,14969652,15016366,15378,2
Ca$h,46488,0,46488,16469,27
35 Shots of Rum,177511,794330,971841,9576,1
Defendor,44462,0,44462,13265,3
Band Baaja Baaraat,43820,60712,104532,43820,32
The Oath,42273,0,42273,5760,1
On the Bowery,41802,0,41802,13236,1
Kites,41783,20214,61997,24869,40
44 Inch Chest,39033,255212,294245,4185,1
Amelia,14246488,5396598,19643086,3904047,820
The Red Baron,37189,3050,40239,13931,15
Army of Crime,37031,1162846,1199877,8102,3
District 13: Ultimatum,36136,14067616,14103752,11870,9
Mystery Team,89442,0,89442,7840,1
The Legend of Pale Male,38083,0,38083,12910,1
The Yes Men Fix the World,194533,47335,241868,1242,2
Bhutto,100202,0,100202,8275,2
Hideaway,34525,885700,920225,11124,4
Bluebeard,33490,5206,38696,8370,1
Ahead of Time: The Extraordinary Journey of Ruth Gruber,33024,0,33024,12790,1
Spoken Word,32961,0,32961,2343,1
William S. Burroughs: A Man Within,46380,0,46380,6510,1
Boxing Gym,32476,0,32476,0,0
Beetle Queen Conquers Tokyo,32308,0,32308,6498,1
Every Man for Himself,47262,0,47262,7926,1
Living in Emergency,32208,0,32208,21905,7
180° South,31745,0,31745,10269,4
Around a Small Mountain,33216,237714,270930,5326,1
Who Is Harry Nilsson (And Why Is Everybody Talkin' About Him?),30975,0,30975,6078,1
The Sun,77303,0,77303,11588,1
GasLand,30846,18582,49428,2641,1
Valhalla Rising,30638,252099,282737,7905,1
In My Sleep,30158,0,30158,9285,1
Terkel in Trouble,40385,0,40385,3972,2
Lbs.,29866,0,29866,11690,1
Multiple Sarcasms,29731,0,29731,16025,15
Two in the Wave,28808,0,28808,5676,1
Seraphine,884613,8444763,9329376,38637,6
[Rec] 2,27766,18825398,18853164,8191,5
Here and There,27156,25151,52307,6352,1
The Box,15051977,18281554,33333531,7571417,2635
Eyes Wide Open,26258,250318,276576,6818,1
October Country,26185,0,26185,7026,1
The Exploding Girl,25572,0,25572,5910,1
Fresh,25115,0,25115,0,0
Henri-Georges Clouzot's Inferno,25489,26514,52003,3981,1
Behind the Burly Q,23889,0,23889,3958,1
Saint Misbehavin': The Wavy Gravy Movie,29893,0,29893,10976,3
Videocracy,23720,1155956,1179676,8324,1
The Other City,22539,0,22539,10396,2
Happy Tears,22464,0,22464,13009,15
The Garden of Eden,22083,0,22083,12404,14
And Everything Is Going Fine,22080,0,22080,7035,1
Daddy Longlegs,21766,11451,33217,8323,1
Toe to Toe,21648,0,21648,5205,1
The Good Heart,20930,325921,346851,5955,5
Douchebag,20615,0,20615,2966,1
The Korean,20279,0,20279,4002,1
Double Take,20218,0,20218,4650,1
The Trial,19753,0,19753,8957,1
Guy and Madeline on a Park Bench,35556,0,35556,3233,1
Neshoba,19245,0,19245,4645,1
The People I've Slept With,19137,0,19137,3716,1
The Horse Boy,156612,0,156612,6554,3
Small Change,38296,0,38296,4624,1
Off and Running,18262,0,18262,7978,1
Great Directors,17921,0,17921,5440,3
Bitch Slap,17365,422222,439587,12254,3
Red Hill,21087,303337,324424,8650,5
The Polar Express,514354,0,514354,2957,1
The Freebie,16613,0,16613,4309,1
The End of Poverty?,57805,0,57805,12593,1
Breakdance Academy,15628,0,15628,7591,1
Dreamkiller,15514,0,15514,861,3
The Wedding Song,31160,527329,558489,1240,1
Four Seasons Lodge,58334,0,58334,11667,1
The Beaches of Agnès,239711,1985719,2225430,19032,3
Nine Nation Animation,38382,0,38382,2834,1
Le combat dans l'île,50039,0,50039,10217,1
"Police, Adjective",53206,109768,162974,19452,8
The Two Escobars,14457,0,14457,0,0
Shoah,20175,0,20175,2874,1
Ghetto Physics,14034,0,14034,10087,9
Don McKay,13722,0,13722,8919,7
Paper Man,13514,0,13514,8613,3
Jim,13000,0,13000,7809,1
Good Hair,4157223,5912,4163135,1039220,186
The Living Wake,12232,0,12232,3821,1
The Kids Grow Up,12095,0,12095,4497,1
The Dry Land,11777,0,11777,7351,5
Picture Me,12008,10361,22369,6718,1
White Wedding,11710,0,11710,5860,4
Salt of This Sea,11662,174383,186045,4973,1
The Damned United,449865,3641513,4091378,32065,6
Violet Tendencies,13304,0,13304,5264,1
After the Cup: Sons of Sakhnin United,11538,0,11538,2501,1
Terkel in Trouble,10783,0,10783,3648,2
Cherry,11362,25103,36465,2416,1
Children of Invention,11183,0,11183,4874,2
Spring Fever,10824,150286,161110,854,1
Mississippi Mermaid,33216,0,33216,3668,1
Frankie & Alice,10670,0,10670,7768,1
Waiting for Armageddon,10501,0,10501,2579,1
The Milk of Sorrow,10462,1543515,1553977,1914,1
Circle,10024,0,10024,3926,2
"Hugh Hefner: Playboy, Activist and Rebel",10000,0,10000,10000,4
Shanghai Red,30353,0,30353,3008,1
Down Terrace,9812,0,9812,3088,2
Summer Wars,80768,18353560,18434328,1412,1
The Taqwacores,11445,1394,12839,3532,1
Wonderful World,9309,0,9309,4582,4
Brotherhood,8979,231908,240887,2341,1
Only When I Dance,8738,0,8738,2181,1
Brutal Beauty: Tales of the Rose City Rollers,9677,0,9677,0,0
Youssou Ndour: I Bring What I Love,172225,11278,183503,32598,3
Amreeka,627436,1548868,2176304,58823,4
All About Evil,7995,0,7995,5070,1
Stolen,7943,0,7943,1035,1
Mugabe and the White African,7924,0,7924,1907,1
The Missing Person,17896,0,17896,2715,1
The Cove,857005,330429,1187434,57640,4
Tales from the Script,7535,0,7535,1938,1
Udaan,7461,0,7461,2715,2
The Thorn in the Heart,7376,10473,17849,5173,1
Gangster's Paradise: Jerusalema,7294,0,7294,4958,4
Happiness Runs,7199,0,7199,2674,1
Crude,170295,15586,185881,16595,1
Logan,7137,0,7137,7137,1
Misconceptions,6892,0,6892,3796,2
Departures,1498210,68943919,70442129,74945,9
Finding Bliss,6783,0,6783,2115,1
Mercy,6780,0,6780,1776,1
Regina Spektor Live in London,6684,0,6684,1798,9
Dream Boy,6534,0,6534,2243,1
Under Our Skin,98548,0,98548,7043,1
Home,15925,2170791,2186716,1403,1
Monsieur Verdoux,64636,0,64636,0,0
Watercolors,6305,0,6305,3207,2
BearCity,6000,0,6000,5980,1
Oy Vey! My Son Is Gay!!,89507,0,89507,4042,1
Sweethearts of the Prison Rodeo,5922,0,5922,2198,2
The Fall of Night,5673,0,5673,1029,1
Whiz Kids,5386,0,5386,1333,1
Speed-Dating,5240,0,5240,3394,1
Come Undone,10035,3091430,3101465,2030,1
Beeswax,46590,0,46590,5844,1
Zenith,7862,0,7862,2347,1
The Strange Case of Angelica,50135,97038,147173,7499,1
The Oxford Murders,4803,17641824,17646627,1191,1
The September Issue,3820067,2622233,6442300,220633,6
Harmony and Me,20099,0,20099,0,0
The Law,17351,0,17351,0,0
Big Fan,234540,0,234540,24266,2
The Flower of Kim Jong II,4362,0,4362,1497,1
Cloud 9,91675,4772788,4864463,6617,1
The Headless Woman,100177,205589,305766,14778,1
Helena from the Wedding,4190,0,4190,2692,1
Promised Lands,4546,0,4546,797,1
Inhale,4115,75997,80112,3030,2
Just Say Love,3944,0,3944,1257,1
In/Significant Others,3763,0,3763,1408,1
The Wild Child,65051,0,65051,6680,1
Nénette,18009,10690,28699,1176,1
Heartless,3697,0,3697,2033,1
Smash His Camera,3644,0,3644,2367,1
American Grindhouse,5529,0,5529,0,0
Metal Messiah,3476,0,3476,0,0
The Full Picture,3467,0,3467,1358,1
Fashion Victim,3346,0,3346,1046,2
El Superstar: The Unlikely Rise of Juan Frances,3271,0,3271,2330,1
Hadewijch,5006,69580,74586,1892,1
My Year Without Sex,3119,802164,805283,528,1
Altiplano,2961,154835,157796,1269,1
Bliss,40349,0,40349,7039,1
Adolf Eichmann,2706,0,2706,573,1
The Slammin' Salmon,41587,18834,60421,26167,11
Yuri Gagarin Conspiracy: Fallen Idol,14471,0,14471,2546,2
Boogie Woogie,2618,45793,48411,1776,1
Daniel and Ana,2372,0,2372,1400,1
The Afterlight,3059,0,3059,1466,1
You Wont Miss Me,2240,0,2240,2240,1
The Girl,2201,72,2273,712,1
"Yoo-Hoo, Mrs. Goldberg",1134623,0,1134623,19302,2
NoBody's Perfect,2122,0,2122,533,1
The Fall,2266905,1402560,3669465,79611,9
White on Rice,69171,0,69171,8079,2
As Good as Dead,1981,53637,55618,1494,1
Falling Awake,1978,0,1978,847,2
The Temptation of St. Tony,1963,0,1963,747,1
Endgame,9645,16615,26260,1608,14
A Mother's Courage: Talking Back to Autism,1916,0,1916,822,2
$9.99,52384,655970,708354,478,1
The Red Chapel,6196,0,6196,2459,1
Manuela and Manuel,1582,0,1582,629,1
Carbon Nation,16901,0,16901,402,1
"Carmo, Hit the Road",1512,0,1512,835,1
Drool,1403,0,1403,1199,1
Trucker,52429,0,52429,9458,10
Phil Ochs: There But for Fortune,263723,0,263723,18211,1
The Wonder of It All,781016,0,781016,18988,3
45365,853,0,853,107,1
Perrier's Bounty,828,167110,167938,828,1
Shall We Kiss?,535499,2400938,2936437,28680,4
Peter and Vandy,11495,0,11495,7323,3
Shake Hands with the Devil,594,0,594,86,1
The Magician,406,0,406,117,1
"If I Want to Whistle, I Whistle",12135,268757,280892,2999,1
Tru Loved,9467,0,9467,1678,2
Box Elder,48996,0,48996,3188,1
The Blue Tooth Virgin,2762,0,2762,1926,2
Breakfast with Scot,46060,0,46060,11455,5
To Die Is Hard,5129,0,5129,112,1
From Mexico with Love,548787,708,549495,334340,279
Harry Potter and the Deathly Hallows: Part 2,381011219,960500000,1341511219,169189427,4375
Transformers: Dark of the Moon,352390543,771403536,1123794079,97852865,4088
The Twilight Saga: Breaking Dawn - Part 1,281287133,430918723,712205856,138122261,4061
The Hangover Part II,254464305,332300000,586764305,85946294,3615
Pirates of the Caribbean: On Stranger Tides,241071802,804642000,1045713802,90151958,4155
Fast Five,209837675,416300000,626137675,86198765,3644
Cars 2,191452396,368400000,559852396,66135507,4115
Thor,181030624,268295994,449326618,65723338,3955
Rise of the Planet of the Apes,176760185,305040688,481800873,54806191,3648
Captain America: The First Avenger,176654505,193915269,370569774,65058524,3715
The Help,169708112,46931000,216639112,26044590,2534
Bridesmaids,169106725,119276798,288383523,26247410,2918
Kung Fu Panda 2,165249063,500443218,665692281,47656302,3925
X-Men: First Class,146408305,206208385,352616690,55101604,3641
Puss in Boots,149260504,405726973,554987477,34077439,3952
Rio,143619809,340246709,483866518,39225962,3826
The Smurfs,142614158,421135165,563749323,35611637,3395
Super 8,127004179,133091807,260095986,35451168,3379
Sherlock Holmes: A Game of Shadows,186848418,357000000,543848418,39637079,3703
Rango,123477607,122246996,245724603,38079323,3917
Mission: Impossible - Ghost Protocol,209397903,485315477,694713380,12785204,425
The King's Speech,135453143,288545959,423999102,355450,4
Horrible Bosses,117538559,92300000,209838559,28302165,3040
Green Lantern,116601172,103250000,219851172,53174303,3816
Hop,108085305,75868418,183953723,37543710,3579
Paranormal Activity 3,104028807,103011037,207039844,52568183,3321
Just Go with It,103028109,111917482,214945591,30514732,3548
True Grit,171243005,81033922,252276927,24830443,3047
Bad Teacher,100292856,115904636,216197492,31603106,3049
Cowboys & Aliens,100240551,74581774,174822325,36431290,3750
Gnomeo & Juliet,99967670,94000000,193967670,25356909,2994
The Green Hornet,98780042,129037206,227817248,33526876,3584
The Lion King,94242001,91300000,185542001,30151614,2330
Alvin and the Chipmunks: Chipwrecked,133110742,209584693,342695435,23244744,3723
Real Steel,85468508,213800000,299268508,27319677,3440
"Crazy, Stupid, Love",84351197,60700000,145051197,19104303,3020
Battle Los Angeles,83552429,128266925,211819354,35573187,3417
Immortals,83504017,143400000,226904017,32206425,3112
The Muppets,88631237,76553000,165184237,29239026,3440
Zookeeper,80360843,89491916,169852759,20065617,3482
Limitless,79249455,82600000,161849455,18907302,2756
Tower Heist,78046570,74884053,152930623,24025190,3367
Contagion,75658097,60857770,136515867,22403596,3222
Moneyball,75605492,34600724,110206216,19501302,2993
Justin Bieber: Never Say Never,73013910,26022917,99036827,29514054,3105
Dolphin Tale,72286779,23645786,95932565,19152401,3507
Jack and Jill,74158157,75515631,149673788,25003575,3438
No Strings Attached,70662220,78565857,149228077,19652921,3018
Mr. Popper's Penguins,68224452,119137302,187361754,18445355,3339
Black Swan,106954678,222443368,329398046,1443809,18
Little Fockers,148438600,162211985,310650585,30833665,3536
Unknown,63686397,72023632,135710029,21856389,3043
The Adjustment Bureau,62495645,65373734,127869379,21157730,2840
Happy Feet Two,64006466,95189793,159196259,21237068,3606
Water for Elephants,58709717,58385185,117094902,16842353,2817
The Lincoln Lawyer,58009200,28743152,86752352,13206453,2707
Midnight in Paris,56817045,97142545,153959590,599003,6
Friends with Benefits,55802754,93739491,149542245,18622150,2926
I Am Number Four,55100437,94778000,149878437,19449893,3154
Source Code,54712227,92620470,147332697,14812094,2961
The Fighter,93617009,35573860,129190869,300010,4
TRON: Legacy,172062763,228000000,400062763,44026211,3451
Insidious,54009150,45547882,99557032,13271464,2408
Tyler Perry's Madea's Big Happy Family,53345287,816000,54161287,25068677,2288
Diary of a Wimpy Kid: Rodrick Rules,52698535,19828461,72526996,23751502,3167
Footloose,51802742,11740586,63543328,15556113,3549
The Girl with the Dragon Tattoo,102515793,130101637,232617430,12768604,2914
Hugo,73864507,111905653,185770160,11364505,1277
The Dilemma,48475290,21246676,69721966,17816230,2940
Arthur Christmas,46462469,100957003,147419472,12068931,3376
Hall Pass,45060734,41096503,86157237,13535374,2950
New Year's Eve,54544638,87500000,142044638,13019180,3505
Soul Surfer,43853424,3267524,47120948,10601862,2214
The Adventures of Tintin,77591831,296402120,373993951,9720993,3087
Yogi Bear,100246011,103264186,203510197,16411322,3515
Final Destination 5,42587643,115300000,157887643,18031396,3155
The Ides of March,40962534,35375577,76338111,10470143,2199
Hanna,40259119,23522959,63782078,12370549,2535
Tangled,200821936,391639796,592461732,48767052,3603
Something Borrowed,39046489,26053880,65100369,13945368,2904
Spy Kids 4-D: All the Time in the World,38538188,47026122,85564310,11644672,3295
The Descendants,82584160,94659025,177243185,1190096,29
Scream 4,38180928,58957758,97138686,18692090,3305
"Big Mommas: Like Father, Like Son",37915414,44770652,82686066,16300803,2821
Red Riding Hood,37662162,52598214,90260376,14005335,3030
Paul,37412945,60571070,97984015,13043310,2802
The Roommate,37300000,3192652,40492652,15002635,2534
We Bought a Zoo,75624550,44457291,120081841,9360434,3117
Jumping the Broom,37295394,863207,38158601,15215487,2035
The Change-Up,37081475,38368962,75450437,13531115,2913
30 Minutes or Less,37053924,3608708,40662632,13330118,2888
In Time,37520095,136410501,173930596,12050368,3122
Colombiana,36665854,26792586,63458440,10408176,2614
J. Edgar,37306030,47614509,84920539,11217324,1910
Sucker Punch,36392502,53400000,89792502,19058199,3033
War Horse,79884879,97700000,177584879,7515402,2376
Larry Crowne,35608245,39446825,75055070,13096065,2973
50/50,35014192,6083661,41097853,8644095,2458
A Very Harold & Kumar Christmas,35061031,1131744,36192775,12954142,2875
Drive,35061555,41915111,76976666,11340461,2886
Courageous,34522221,663663,35185884,9112839,1161
The Rite,33047633,63512958,96560591,14789393,2985
Arthur,33035397,15112548,48147945,12222756,3276
The Debt,31177548,14458820,45636368,9909499,1826
Priest,29137000,49172505,78309505,14953664,2864
The Mechanic,29121498,47008595,76130093,11422006,2703
Abduction,28087155,54000000,82087155,10925253,3118
Beastly,27865571,15336712,43202283,9851102,1952
Winnie the Pooh,26692846,23178583,49871429,7857076,2405
The Sitter,30441326,4500862,34942188,9851435,2750
Killer Elite,25124966,31959556,57084522,9352008,2986
Season of the Witch,24827228,66800000,91627228,10612375,2816
Our Idiot Brother,24816118,988330,25804448,7011631,2555
The Chronicles of Narnia: The Voyage of the Dawn Treader,104386950,311299267,415686217,24005069,3555
Don't Be Afraid of the Dark,24046682,14222847,38269529,8525728,2760
Sanctum,23209310,85400000,108609310,9447930,2787
Monte Carlo,23186769,16595914,39782683,7453944,2473
Gulliver's Travels,42779261,194603463,237382724,6307691,2546
Your Highness,21596445,6417288,28013733,9360020,2769
Mars Needs Moms,21392758,17840920,39233678,6914488,3117
Dream House,21302340,18682060,39984400,8129355,2661
Conan the Barbarian,21295021,42228262,63523283,10021215,3015
The Three Musketeers,20374484,111900000,132274484,8674452,3017
Country Strong,20218921,310273,20529194,30452,2
The Eagle,19490041,18499643,37989684,8684464,2296
Shark Night 3D,18877153,22486774,41363927,8404260,2806
Fright Night,18302607,22700000,41002607,7714388,3114
Apollo 18,17687709,8548444,26236153,8704271,3328
The Tourist,67631157,211149284,278780441,16472458,2756
The Thing,16928670,14576617,31505287,8493665,2996
Harry Potter and the Deathly Hallows: Part 1,295983305,680553613,976536918,125017372,4125
African Cats,15428747,15429000,30857747,6003200,1220
Born to Be Wild,25978556,15665919,41644475,871478,206
Judy Moody and the Not Bummer Summer,15013650,677990,15691640,6076859,2524
What's Your Number?,14011084,16415012,30426096,5421669,3002
One Day,13843771,45545662,59389433,5079566,1719
Warrior,13657115,9651500,23308615,5242107,1869
The Tree of Life,13303319,45105928,58409247,372920,4
The Rum Diary,13109815,17025143,30134958,5135369,2273
Glee: The 3D Concert Movie,11862398,6800840,18663238,5961231,2040
The Darkest Hour,21443494,43183292,64626786,2993519,2324
The Conspirator,11538204,4084979,15623183,3506602,707
Young Adult,16311571,6627456,22939027,310263,8
Jane Eyre,11242660,23467967,34710627,182885,4
Drive Angry,10721033,30188876,40909909,5187625,2290
Straw Dogs,10324441,844271,11168712,5123760,2408
Win Win,10179275,1610338,11789613,150362,5
Hoodwinked!,10143779,13024065,23167844,4108630,2505
Prom,10130219,572027,10702246,4712638,2730
Hubble 3D,52522904,21726825,74249729,413477,39
I Don't Know How She Does It,9662284,21747867,31410151,4402201,2476
Blue Valentine,9706328,5186090,14892418,193728,4
My Week with Marilyn,14600347,20457349,35057696,1750507,244
How Do You Know,30212620,18456287,48668907,7484696,2483
Johnny English Reborn,8305970,151772616,160078586,3833300,1552
127 Hours,18335230,42403567,60738797,264851,4
Kevin Hart: Laugh at My Pain,7706436,0,7706436,1908420,98
Elle s'appelait Sarah,7693187,17099628,24792815,115708,5
The Big Year,7204138,975278,8179416,3251884,2150
Take Me Home Tonight,6928068,622005,7550073,3464679,2003
Cedar Rapids,6861102,867834,7728936,302968,15
Beginners,5790894,8520807,14311701,141340,5
The Guard,5360274,14201630,19561904,76834,4
Cave of Forgotten Dreams,5304920,2878427,8183347,139101,5
Margin Call,5354039,14150000,19504039,561906,56
Biutiful,5101237,20046549,25147786,457206,59
Megamind,148415853,173469912,321885765,46016833,3944
Atlas Shrugged: Part I,4627375,0,4627375,1677000,299
The Artist,44671682,88761174,133432856,204878,4
Anonymous,4463292,10931795,15395087,1021768,265
The Company Men,4441272,3645728,8087000,647797,106
Barney's Version,4439201,7665564,12104765,65241,4
Seven Days in Utopia,4373074,0,4373074,1316910,561
The Way,4430765,4007107,8437872,110418,33
The Social Network,96962694,127957621,224920315,22445653,2771
Buck,4038912,409816,4448728,67548,4
Of Gods and Men,3951596,39851821,43803417,308895,33
Under the Sea 3D,36262926,19639698,55902624,661185,49
Tinker Tailor Soldier Spy,24149393,57095212,81244605,310562,4
Like Crazy,3395391,336098,3731489,123140,4
The King's Speech,3344306,30909,3375215,1133162,1011
Sea Rex 3D: Journey to a Prehistoric World,6096582,9907568,16004150,5000000,0
Zindagi Na Milegi Dobara,3108485,2084258,5192743,960548,100
From Prada to Nada,3033623,1025071,4058694,1115638,256
The Skin I Live In,3185812,30492594,33678406,223119,6
Martha Marcy May Marlene,2990625,1787814,4778439,137651,4
Another Year,3205706,16517060,19722766,111869,6
Don 2,3680306,3233212,6913518,1673921,157
Everything Must Go,2711643,108847,2820490,791676,218
The Way Back,2701859,21470342,24172201,1218868,678
Bucky Larson: Born to Be a Star,2529395,999,2530394,1415023,1500
Ra.One,2511689,33400000,35911689,0,0
Melancholia,3030848,14008966,17039814,257174,19
Unstoppable,81562942,86242524,167805466,22688457,3207
The Grace Card,2430735,0,2430735,1040000,352
Space Station 3D,93383953,34979928,128363881,489488,24
The Illusionist,2231474,3775720,6007194,38594,3
Incendies,2071334,5028264,7099598,50679,3
Burlesque,39440655,50079118,89519773,11947744,3037
The Trip,2030962,1710236,3741198,77904,6
Rabbit Hole,2229058,2911867,5140925,53778,5
The Mighty Macs,1891936,0,1891936,963221,975
Shame,3909002,15214765,19123767,361000,10
Bodyguard,1834384,2856108,4690492,863751,88
A Better Life,1759252,104254,1863506,62087,4
Take Shelter,1730296,2010802,3741098,52041,3
Potiche,1618844,30691037,32309881,86017,7
Senna,1612430,8585231,10197661,73497,2
Due Date,100539043,111241781,211780824,32689406,3355
I Am,1591034,0,1591034,10092,1
Delhi Belly,1532594,15173480,16706074,581943,89
The Double Hour,1514942,1333223,2848165,30246,2
Bill Cunningham: New York,1510026,700356,2210382,33677,1
Somewhere,1785645,13002997,14788642,119086,7
The Art of Getting By,1430241,461889,1892130,679160,610
A Dangerous Method,5704709,24814727,30519436,167953,4
Saving Private Perez,1400726,7929739,9330465,664517,161
Certified Copy,1373975,6362657,7736632,77937,5
The Devil's Double,1361512,4366701,5728213,96414,5
The Oscar Nominated Short Films 2011: Live Action,1352152,0,1352152,300706,95
Snow Flower and the Secret Fan,1348205,10000000,11348205,134005,24
"It's Not You, It's Me",1339911,9962045,11301956,588938,226
Another Earth,1321194,617589,1938783,77740,4
Love & Other Drugs,32367005,70453003,102820008,9739161,2455
"Beats, Rhymes & Life: The Travels of A Tribe Called Quest",1200326,0,1200326,111982,4
Kill the Irishman,1188194,0,1188194,145430,5
Dylan Dog: Dead of Night,1186538,4595977,5782515,754779,875
The Whistleblower,1124966,745426,1870392,61002,7
Red State,1104682,769778,1874460,204230,1
The Heart Specialist,1103037,0,1103037,473062,422
RED,90380162,108626225,199006387,21761408,3255
Desi Boyz,1078826,1276467,2355293,702325,103
There Be Dragons,1069334,3303308,4372642,705537,259
I Love You Phillip Morris,2037459,18685384,20722843,112520,6
Page One: Inside the New York Times,1067028,10954,1077982,28911,2
Attack the Block,1024175,5181847,6206022,139506,8
Inside Job,4312735,3558787,7871522,39649,2
In a Better World,1008098,11996406,13004504,33058,4
Crazy Mad Lover,993031,604238,1597269,504116,84
Rockstar,986697,664904,1651601,612235,112
Meek's Cutoff,977772,227485,1205257,20024,2
The Beaver,970816,6323984,7294800,107577,22
Blank City,116037,3892,119929,13989,1
Ready,955148,1377766,2332914,460238,97
Casino Jack,1042959,166750,1209709,34528,7
Sholem Aleichem: Laughing in the Darkness,906666,0,906666,20247,1
Higher Ground,841733,1637,843370,21495,3
Secretariat,59713955,607906,60321861,12694770,3072
The Lord of the Rings: The Return of the King,818580,0,818580,94000000,0
13 Assassins,802778,17886280,18689058,45854,4
The Lord of the Rings: The Fellowship of the Ring,768580,0,768580,93000000,0
The Lord of the Rings: The Two Towers,764607,0,764607,94000000,0
Forks Over Knives,739561,0,739561,17645,1
Mausam,728316,745025,1473341,459024,96
Point Blank,708215,8779230,9487445,41031,6
The Hedgehog,707945,11198772,11906717,39276,6
The Polar Express,711168,0,711168,55299,19
Hobo with a Shotgun,703372,45081,748453,12046,2
Tabloid,696921,35004,731925,91201,14
Mozart's Sister,707885,1117006,1824891,34046,7
Made in Dagenham,1095369,11534102,12629471,37563,3
My Afternoons with Margueritte,666557,16440586,17107143,20900,2
Terri,655802,0,655802,65103,6
Reservation,651096,397411,1048507,344661,91
Life as We Know It,53374681,52359735,105734416,14506464,3150
The Greatest Movie Ever Sold,638476,59773,698249,118294,18
The Last Lions,635325,0,635325,53344,4
Mumbai Diaries,576639,2506319,3082958,365297,78
The Future,568662,318510,887172,27137,1
Take a Shot,564489,944423,1508912,327523,101
Double Dhamaal,543646,628594,1172240,301831,54
Winter in Wartime,543100,80292,623392,14937,3
Love Crime,539792,3124126,3663918,35375,5
Machine Gun Preacher,538690,2800000,3338690,45130,4
The Greatest Miracle,555166,2464216,3019382,35768,13
Even the Rain,518017,6795468,7313485,53730,8
Deep Sea,46412757,51818148,98230905,700213,43
The Names of Love,514237,6289650,6803887,30372,5
Creature,508714,24521,533235,327000,1507
Bride Flight,501360,0,501360,54044,18
Weekend,484592,643885,1128477,27245,1
Mere Brother Ki Dulhan,496172,931103,1427275,403017,74
Fair Game,9540691,16258224,25798915,651082,46
Queen to Play,478710,1978012,2456722,28092,6
Pearl Jam Twenty,471334,0,471334,102448,7
Submarine,467602,3407571,3875173,41832,4
Thank You,463540,4988807,5452347,244183,92
Detective Dee: Mystery of the Phantom Flame,459836,51439433,51899269,52617,3
The Women on the 6th Floor,719823,26814147,27533970,26200,6
Circumstance,454121,101390,555511,43318,7
No One Killed Jessica,440525,193772,634297,227473,48
Faster,23240020,12386938,35626958,8523153,2454
Despicable Me,251513985,291600000,543113985,56397125,3476
The Salvation Poem,914818,182932,1097750,0,0
Project Nim,411184,198696,609880,25820,4
Le Havre,611709,12347997,12959706,26363,6
The 5th Quarter,408159,0,408159,202342,123
Turtle: The Incredible Journey,386073,2558994,2945067,69389,24
Hesher,382946,66756,449702,126046,42
Miral,373420,759423,1132843,66244,4
Mooz-Lum,369129,0,369129,139835,11
Poetry,356149,2176940,2533089,18900,3
The Princess of Montpensier,352428,6612773,6965201,23456,3
Singham,350864,371587,722451,161063,50
The First Grader,332000,862710,1194710,20437,3
Super,327716,94902,422618,46549,11
Galapagos,18630372,10718800,29349172,0,0
L'amour fou,312494,176632,489126,37250,2
Carnage,2547047,28175585,30722632,79795,5
Winter's Bone,6531503,7265331,13796834,84797,4
Morning Glory,31011732,29029244,60040976,9203266,2518
All Good Things,582024,1107622,1689646,37172,2
Rascals,273829,378927,652756,168082,61
The Black Power Mixtape 1967-1975,273749,6276,280025,17316,2
The Interrupters,282448,4009,286457,7920,1
The Mill and the Cross,312187,803993,1116180,11354,1
Seven Sins Forgiven,270207,95465,365672,164153,65
Conan O'Brien Can't Stop,267965,0,267965,97043,24
Extremely Loud & Incredibly Close,31847881,23400000,55247881,72348,6
Munger Road,266689,0,266689,36605,1
Sea Monsters: A Prehistoric Adventure,23746066,26906397,50652463,605722,252
Phil Ochs: There But for Fortune,263723,0,263723,18211,1
The Music Never Stopped,258223,0,258223,76543,32
Passione,255355,452105,707460,15377,1
Trollhunter,253444,5087654,5341098,5585,1
Life in a Day,252788,354381,607169,45202,11
War of the Arrows,251200,50336461,50587661,24041,1
My Perestroika,242707,0,242707,17680,1
Being Elmo: A Puppeteer's Journey,304052,6760,310812,22963,1
Gainsbourg: A Heroic Life,233007,11987449,12220456,25189,3
Brighton Rock,229653,2683946,2913599,32774,12
Into the Abyss,223880,169834,393714,47559,12
Tucker and Dale vs Evil,223838,5001100,5224938,52843,30
Happythankyoumoreplease,216110,637752,853862,35063,2
The Afflicted,212940,0,212940,90272,13
The Wildest Dream,898137,0,898137,67848,12
Ip Man 2,205675,14856127,15061802,61057,20
"Filth to Ashes, Flesh to Dust",202531,0,202531,86086,11
El Bulli: Cooking in Progress,237181,105935,343116,12756,1
A Good Old Fashioned Orgy,200227,1169258,1369485,117564,143
The Girl Who Kicked the Hornet's Nest,5190196,39086139,44276335,881737,154
October Baby,199442,0,199442,102096,13
Pina,3524826,15181027,18705853,68012,3
Legend of the Guardians: The Owls of Ga'Hoole,55675313,84398077,140073390,16112211,3575
Bol,188850,321022,509872,62473,38
Blackthorn,200558,787325,987883,15254,8
Uncle Boonmee Who Can Recall His Past Lives,184292,1027914,1212206,23540,3
Jig,183790,179530,363320,70432,5
Amigo,184705,0,184705,37324,10
Go for It!,180237,0,180237,119714,218
Jackass 3D,117229692,54456100,171685792,50353641,3081
Bellflower,168226,4709,172935,22279,2
"The Man Nobody Knew: In Search of My Father, CIA Spymaster William Colby",183342,0,183342,15411,1
The Last Godfather,164247,16699382,16863629,101779,58
Restless,163265,2354747,2518012,15467,5
Pastorela,161194,3017828,3179022,82175,55
The Housemaid,157961,14880340,15038301,16670,2
Magic Trip: Ken Kesey's Search for a Kool Place,154521,484,155005,14367,4
3-D Sex and Zen: Extreme Ecstasy,153215,10153592,10306807,903,1
Nostalgia for the Light,163962,13672,177634,5664,1
Le Quattro Volte,152530,548804,701334,16192,1
Beginning of the Great Revival,151000,58158289,58309289,65866,29
Revenge of the Electric Car,150886,386,151272,17482,2
Gun Hill Road,148994,0,148994,37963,3
Thunder Soul,143986,0,143986,51260,35
The Iron Lady,30017992,85872707,115890699,220409,4
The Human Centipede II (Full Sequence),141877,28446,170323,49456,18
Paranormal Activity 2,84752907,92759125,177512032,40678424,3216
Cold Weather,141358,2698,144056,14513,1
Game,139528,242383,381911,83783,63
The Double,137921,4591934,4729855,26640,11
Red Lips,136163,1753706,1889869,73476,67
Eames: The Architect & The Painter,153088,6627,159715,0,0
I Will Follow,135809,0,135809,56176,5
1911,135739,3544412,3680151,55850,33
"Life, Above All",134461,96068,230529,13788,5
Evangelion: 2.0 You Can (Not) Advance,133640,41028401,41162041,84157,15
If You Are the One 2,426894,75658549,76085443,182517,20
I Saw the Devil,129210,12837147,12966357,13567,2
Tees Maar Khan,1076443,1377971,2454414,539793,108
What Women Want,123526,11714651,11838177,53224,26
The Last Mountain,122961,0,122961,17570,2
City of Life and Death,122558,10564758,10687316,5610,1
Vision,435274,4608604,5043878,11406,1
Trust,120016,475786,595802,58214,28
Tiny Furniture,391674,0,391674,21235,1
Sigur Rós: Inni,123482,0,123482,14903,3
Kaboom,118919,516243,635162,13714,1
The Undefeated,116381,0,116381,65132,10
35 and Ticking,113794,0,113794,29808,6
Mysteries of Lisbon,110507,146558,257065,12308,2
The Warrior's Way,5666340,5437094,11103434,3048665,1622
Henry's Crime,102541,2067258,2169799,8726,2
Young Goethe in Love,162138,5664427,5826565,17143,6
Rubber,100370,1359,101729,16346,5
Rejoice and Shout,100237,0,100237,6589,1
The Man Who Fell to Earth,100072,396,100468,5922,1
A Little Help,96868,0,96868,44870,24
My Dog Tulip,246574,0,246574,11550,1
Last Night,99000,10928222,11027222,29505,10
Tomboy,129834,1307667,1437501,7078,1
Chalo Dilli,94300,96885,191185,38268,31
American: The Bill Hicks Story,92234,0,92234,5872,1
Evil Bong 3: The Wrath of Bong,91260,0,91260,24775,1
Oy Vey! My Son Is Gay!!,89507,0,89507,4042,1
Exporting Raymond,87727,0,87727,35292,13
Waste Land,187716,103591,291307,9806,1
Vidal Sassoon: The Movie,85974,38558,124532,13053,1
Carancho,85526,4034486,4120012,15810,5
Elite Squad 2: The Enemy Within,100119,63518731,63618850,8648,1
The Robber,83451,171038,254489,2169,1
T-Rex: Back to the Cretaceous,53354743,50605624,103960367,0,0
Inkubus,81600,0,81600,0,0
Circo,77466,0,77466,5403,1
Beautiful Boy,77247,62876,140123,16162,4
Oranges and Sunshine,143480,4874173,5017653,18600,4
Kings of Pastry,336386,0,336386,15162,2
Summer Wars,80768,18353560,18434328,1412,1
Four Lions,304616,5844071,6148687,41512,8
The Tree,71158,2378887,2450045,4983,2
Fireflies in the Garden,70600,0,70600,36884,5
The Warring States,68961,11800000,11868961,35381,23
Puncture,68945,54755,123700,29175,4
Get Low,9176933,1345578,10522511,88182,4
Pariah,769552,0,769552,48579,4
A Beautiful Life,66171,568613,634784,23605,23
Shaolin,66099,42675395,42741494,19132,9
Bhutto,100202,0,100202,8275,2
Battle of the Brides,64572,0,64572,23612,5
The Human Resources Manager,64014,526553,590567,8528,3
Hereafter,32746941,74209389,106956330,220322,6
Public Speaking,62173,0,62173,6260,1
Trigun: Badlands Rumble,62027,0,62027,29201,12
Heartbeats,68723,774700,843423,7197,1
White Material,304020,1088414,1392434,34613,3
If a Tree Falls: A Story of the Earth Liberation Front,61794,0,61794,5634,2
Viva Riva!,61759,107223,168982,10314,3
How to Live Forever,60630,0,60630,3716,1
For Colored Girls,37729698,252286,37981984,19497324,2127
Limelight,60335,0,60335,9259,1
Crime After Crime,60291,0,60291,3215,1
The Whale,81881,0,81881,4835,2
3,59954,3424492,3484446,9821,4
Murder 2,59000,169501,228501,0,0
Undertow,108620,493439,602059,6749,1
Farmageddon,56573,0,56573,2699,1
Finding Joe,55518,0,55518,8753,1
Into Eternity,55366,0,55366,3530,1
Dirty Girl,55125,88360,143485,17859,9
Snowmen,54805,0,54805,54333,16
The Tempest,277943,127918,405861,42436,5
The Other F Word,53714,0,53714,15792,2
My Reincarnation,92822,3293,96115,6498,1
!Women Art Revolution,52681,0,52681,5791,2
Battleship Potemkin,51198,6422,57620,5641,1
Putty Hill,49918,8667,58585,4868,1
Legend of the Fist: The Return of Chen Zhen,50433,27340245,27390678,11365,4
Orgasm Inc.,49001,0,49001,8773,2
The Perfect Host,48764,402121,450885,7505,2
Love U... Mr. Kalakaar!,48557,12399,60956,38268,13
"Lebanon, Pa.",48381,0,48381,6675,2
"The Butcher, the Chef, and the Swordsman",47896,2041370,2089266,23425,37
Pianomania,49852,243018,292870,2238,1
What If...,814906,0,814906,49770,23
Alabama Moon,47305,0,47305,6568,7
Went the Day Well?,47214,0,47214,7849,1
Marwencol,112036,0,112036,3276,1
Diary of a Country Priest,47000,0,47000,7674,1
"Connected: An Autoblogography About Love, Death & Technology",46782,0,46782,13301,3
The Woodmans,46623,0,46623,5874,1
Margaret,46495,518369,564864,7525,2
The Next Three Days,21148651,46300000,67448651,6542779,2564
Every Day,46029,0,46029,9857,3
Rapt,45759,40269,86028,5872,1
Texas Killing Fields,45469,1225850,1271319,8772,3
The Strange Case of Angelica,50135,97038,147173,7499,1
"Happy, Happy",45154,575084,620238,7125,4
In the Land of Blood and Honey,303877,899822,1203699,18854,3
Over Your Cities Grass Will Grow,51301,18955,70256,7272,1
Desert Flower,44348,14638595,14682943,7657,3
Magnificent Desolation: Walking on the Moon 3D,34137524,6201878,40339402,479587,80
Granito,43942,0,43942,4330,1
Crazy Wisdom: The Life & Times of Chogyam Trungpa Rinpoche,86202,0,86202,10304,1
Bereavement,43712,0,43712,20744,20
Love Etc.,43593,0,43593,8781,2
3 Backyards,43073,0,43073,11332,1
Down for Life,41914,0,41914,23176,5
The Conquest,74474,6562692,6637166,16273,6
The Myth of the American Sleepover,41045,0,41045,8700,1
The Last Circus,40548,3564050,3604598,4757,1
CornerStore,45176,0,45176,12743,1
Road to Nowhere,40294,121325,161619,2521,1
Louder Than a Bomb,40000,0,40000,2300,1
We Need to Talk About Kevin,1738692,7493626,9232318,24587,1
Where Soldiers Come From,39201,0,39201,0,0
Summer,43839,0,43839,4957,1
A Somewhat Gentle Man,37743,1788716,1826459,2506,1
Dogtooth,110248,302480,412728,6686,2
Rare Exports,236347,3792624,4028971,9281,1
Film socialisme,42925,79339,122264,4526,1
Sleeping Beauty,36578,372102,408680,9207,2
My Kingdom,36533,399226,435759,16816,20
Tamara Drewe,560391,11477582,12037973,18604,4
Kinyarwanda,35412,0,35412,21097,7
When Harry Tries to Marry,35100,0,35100,23790,4
Love in Space,34787,323699,358486,13795,16
Hell and Back Again,40634,315,40949,3413,1
Beautiful Darling,34096,0,34096,12406,1
Making the Boys,33443,0,33443,7513,1
Stake Land,33245,372135,405380,7258,1
American Teacher,33144,0,33144,6036,2
Meet Monica Velour,33042,0,33042,7438,2
The Time That Remains,32869,1004636,1037505,6453,1
11-11-11,32771,6931101,6963872,32771,17
October,32127,98208,130335,7054,2
"Tuesday, After Christmas",27813,218020,245833,6472,1
The Town,92186262,61839874,154026136,23808032,2861
"Hey, Boo: Harper Lee and 'To Kill a Mockingbird'",31135,0,31135,5457,2
Small Town Murder Songs,31133,0,31133,2810,7
White Irish Drinkers,31056,0,31056,16836,5
The Son of No One,30680,1060452,1091132,18015,10
Howl,617334,661056,1278390,51185,6
A Separation,7099055,15827021,22926076,59481,3
Muran,30116,26377,56493,16490,10
The Outrage,44745,8412996,8457741,6518,2
Cat Run,30000,0,30000,30000,103
Evidence of a Haunting,29904,0,29904,16800,10
Cracks,29683,72177,101860,9467,6
Redemption Road,29384,0,29384,19152,26
The Topp Twins: Untouchable Girls,29316,0,29316,2506,1
The Sleeping Beauty,29066,417065,446131,5973,1
Animal Kingdom,1044039,6164192,7208231,61968,7
Salvation Boulevard,28468,60714,89182,7208,4
Khodorkovsky,39522,255077,294599,6110,1
Clash,27052,0,27052,12249,9
The Last Ride,27000,0,27000,16270,7
Metropolis,27362,113545,140907,0,0
Enemies of the People,73171,7483,80654,2277,1
The Autobiography of Nicolae Ceausescu,34023,33070,67093,4644,1
Caesar and Otto's Summer Camp Massacre,25844,0,25844,11375,5
Waiting for Forever,25517,0,25517,8917,3
Paul Goodman Changed My Life,35671,0,35671,5754,1
Bonnie & Clyde vs. Dracula,25027,0,25027,5688,3
Harvest,24657,0,24657,5870,1
Immigration Tango,24554,0,24554,14432,30
After,24544,0,24544,6333,1
Trespass,24094,10093872,10117966,16816,10
Night Catches Us,76185,0,76185,13562,4
Shut Up Little Man! An Audio Misadventure,23901,0,23901,0,0
Raw Faith,23667,0,23667,0,0
Nine Nation Animation,38382,0,38382,2834,1
Vanishing on 7th Street,22729,1648467,1671196,2898,1
The Other Woman,25423,1425920,1451343,6224,2
Jane's Journey,27253,190362,217615,6193,1
Black Death,22554,249891,272445,6692,2
Incendiary,22457,0,22457,7308,1
Ceremony,22270,25904,48174,6920,2
You Will Meet a Tall Dark Stranger,3248246,32619076,35867322,160103,6
All's Faire in Love,22180,0,22180,16440,75
Answers to Nothing,22029,0,22029,14262,21
The Arbor,21620,104562,126182,2638,1
Monogamy,21527,0,21527,4476,1
Always Kabhi Kabhi,21381,59165,80546,14570,29
Resurrect Dead: The Mystery of the Toynbee Tiles,21242,0,21242,3054,1
Cameraman: The Life and Work of Jack Cardiff,20840,0,20840,1998,1
The Bride Wore Black,44566,0,44566,6463,1
Client 9: The Rise and Fall of Eliot Spitzer,189416,3454,192870,16962,3
Brotherhood,19722,12694,32416,7873,1
When We Leave,19631,1194445,1214076,6018,2
Skateland,19411,0,19411,5254,2
House of Tolerance,19327,1365116,1384443,4766,1
Make Believe,19085,0,19085,0,0
Feed the Fish,101170,0,101170,5820,1
Four Adventures of Reinette and Mirabelle,22039,0,22039,5051,1
Garbo: El espía,28563,0,28563,5593,1
Mesrine Part 1: Killer Instinct,551697,21093,572790,152873,28
Inception,292576195,535745837,828322032,62785337,3792
Battle for Brooklyn,18000,0,18000,11141,1
5 Days of War,17479,299465,316944,6254,2
Archie's Final Project,17282,0,17282,3657,1
Mia and the Migoo,17000,35873,52873,16975,1
House,209765,0,209765,12032,1
The Little Traitor,402088,52393,454481,2330,1
Tyrannosaur,22321,653790,676111,7635,5
London Boulevard,16075,8291152,8307227,3431,1
Anchor Baby,15790,160994,176784,3510,1
Dumbstruck,15379,0,15379,981,1
Carbon Nation,16901,0,16901,402,1
I'm Not Jesus Mommy,15005,0,15005,5280,3
The Tenant,15003,0,15003,750,1
Every Man for Himself,47262,0,47262,7926,1
Ong-bak 3,14890,2325626,2340516,5648,3
Armadillo,14566,2004119,2018685,3958,1
Strange Powers: Stephin Merritt and the Magnetic Fields,68719,0,68719,4620,1
Peep World,14351,0,14351,6702,3
Guy and Madeline on a Park Bench,35556,0,35556,3233,1
Nénette,18009,10690,28699,1176,1
Saheb Biwi Aur Gangster,14231,0,14231,9548,9
Littlerock,17309,0,17309,0,0
William S. Burroughs: A Man Within,46380,0,46380,6510,1
Oka!,18364,0,18364,4461,1
Sympathy for Delicious,13826,0,13826,9448,2
Benda Bilili!,13420,113942,127362,1678,1
Mesrine Part 2: Public Enemy #1,275387,16763,292150,74449,31
The Look,19988,63149,83137,5905,2
Leap Year,12979,175263,188242,2727,1
Under the Boardwalk: The Monopoly Story,13080,0,13080,5054,1
Bloodworth,12971,0,12971,9612,10
America the Beautiful 2: The Thin Commandments,12366,0,12366,5599,3
Rebirth,12358,0,12358,2740,1
Back Door Channels: The Price of Peace,12139,0,12139,3425,1
The Polar Express,672796,1125478,1798274,80505,15
"If I Want to Whistle, I Whistle",12135,268757,280892,2999,1
Carlos,145526,913843,1059369,20006,2
Elektra Luxx,11514,0,11514,5601,4
Special Treatment,8856,285627,294483,678,1
Sarah Palin: You Betcha!,10935,0,10935,6911,6
Happy Magic,10697,394571,405268,5125,5
Marriage Italian Style,10600,0,10600,4967,1
Zero Bridge,10357,0,10357,3304,1
A Bird of the Air,10152,0,10152,3819,1
A Screaming Man,9862,184119,193981,2421,1
Cook County,17977,0,17977,7579,5
Vito Bonafacci,9570,0,9570,3027,1
See What I'm Saying: The Deaf Entertainers Documentary,118206,0,118206,4996,1
The Cremaster Cycle,151239,0,151239,7982,1
The Woman with the 5 Elephants,11026,0,11026,4988,1
The Ledge,9216,1237972,1247188,5176,2
Shanghai Red,30353,0,30353,3008,1
How I Ended This Summer,8733,721679,730412,4968,1
Lucky,8564,0,8564,4986,4
Rid of Me,11740,0,11740,2070,1
Another Happy Day,8464,651473,659937,8464,2
I'm Glad My Mother Is Alive,8705,22435,31140,3118,1
Korkoro,8242,618846,627088,1224,1
Wrecked,8020,221512,229532,2054,1
The Heir Apparent: Largo Winch,10352,43441,53793,2830,4
Good Neighbours,7072,0,7072,2953,3
Addiction Incorporated,40106,0,40106,1629,1
Deep Gold 3D,12000,9868,21868,7000,25
Corman's World: Exploits of a Hollywood Rebel,7000,0,7000,7000,2
My Piece of the Pie,6850,9116337,9123187,4213,2
Janie Jones,6840,0,6840,0,0
Terkel in Trouble,40385,0,40385,3972,2
Monsieur Verdoux,64636,0,64636,0,0
Le Amiche,68167,0,68167,10092,1
I Melt with You,6361,9871,16232,2729,2
Children's Party,6330,825820,832150,4155,7
Shoah,20175,0,20175,2874,1
The Family Tree,6035,0,6035,3658,2
Saint Misbehavin': The Wavy Gravy Movie,29893,0,29893,10976,3
Alamar,61613,241961,303574,7668,1
The Imperialists Are Still Alive!,5874,0,5874,2832,1
Aurora,5677,26043,31720,2105,1
Rage,5594,406373,411967,952,1
Elevate,5580,0,5580,3547,1
My Joy,6298,50559,56857,2077,1
Genius Within: The Inner Life of Glenn Gould,167508,0,167508,17034,3
Miss Minoes,10189,0,10189,1901,3
And They're Off,5154,0,5154,5154,10
London River,7200,0,7200,1044,1
Tanner Hall,5073,0,5073,2803,5
Burke and Hare,4833,4786766,4791599,947,1
Come Undone,10035,3091430,3101465,2030,1
The Red Chapel,6196,0,6196,2459,1
The Catechism Cataclysm,4373,0,4373,897,1
Daylight,4171,0,4171,959,1
Caterpillar,4157,247765,251922,2109,1
Red Hill,21087,303337,324424,8650,5
To Die Like a Man,4029,926,4955,2346,1
Building Hope,4000,0,4000,3500,1
Campus Radio,4000,0,4000,3196,1
Mississippi Mermaid,33216,0,33216,3668,1
Ranchero,24036,0,24036,3826,2
The Harvest/La Cosecha,3709,0,3709,2245,1
Passion Play,3669,21934,25603,2100,2
Prince of the Himalayas,10190,0,10190,0,0
Now & Later,1808,0,1808,1516,1
The Sons of Tennessee Williams,3242,0,3242,1492,1
The Worst Movie Ever!,25206,0,25206,11,1
Plastic Planet,3164,843036,846200,740,1
Balls to the Wall,3140,0,3140,3140,10
Zokkomon,3000,0,3000,2815,24
The Lie,3000,0,3000,3000,1
Zenith,7862,0,7862,2347,1
Protector,2968,1608,4576,2968,2
"El Sicario, Room 164",6123,0,6123,2040,1
Blood Ties,2760,0,2760,2760,1
King of Devil's Island,7615,4352776,4360391,1039,1
Restitution,2664,0,2664,1779,1
United Red Army,2659,0,2659,1161,1
Knuckle,2647,22008,24655,2647,3
Main Street,2560,23451,26011,1553,1
The Girl Who Played with Fire,7638241,59514984,67153225,904998,108
The Legend of Pale Male,38083,0,38083,12910,1
Sidewalls,2377,1005739,1008116,1304,1
The Girl with the Dragon Tattoo,10095170,94319030,104414200,335502,34
Aftershock,62962,100230311,100293273,19329,25
The Pool Boys,2269,0,2269,0,0
The Taqwacores,11445,1394,12839,3532,1
The Weird World of Blowfly,3062,0,3062,1036,1
To Die Is Hard,5129,0,5129,112,1
American Grindhouse,5529,0,5529,0,0
"Love, Wedding, Marriage",1926,513897,515823,1378,2
Around a Small Mountain,33216,237714,270930,5326,1
Hadewijch,5006,69580,74586,1892,1
Violet Tendencies,13304,0,13304,5264,1
Chalet Girl,1710,5466940,5468650,192,1
Small Change,38296,0,38296,4624,1
Little Girl,1350,263148,264498,526,1
The Tunnel,1532,0,1532,507,1
Flypaper,5043,4448591,4453634,1098,2
Mademoiselle Chambon,531685,4979686,5511371,19446,2
Henri-Georges Clouzot's Inferno,25489,26514,52003,3981,1
Brutal Beauty: Tales of the Rose City Rollers,9677,0,9677,0,0
Romeos,1081,18167,19248,773,1
Strangers Online,968,0,968,968,1
Once Upon a Time in Anatolia,152408,1947064,2099472,10952,1
The Afterlight,3059,0,3059,1466,1
Metal Messiah,3476,0,3476,0,0
Illégal,651,289457,290108,404,1
Wretches & Jabberers,84610,0,84610,0,0
A Good Day to Die,573,0,573,0,0
Rosencrantz and Guildenstern Are Undead,71007,0,71007,14370,2
Promised Lands,4546,0,4546,797,1
Redneck Carnage,706,0,706,20000,0
Picture Me,12008,10361,22369,6718,1
Abandoned,832,0,832,407,1
Budrus,68353,0,68353,7819,1
InSight,11100,0,11100,9200,22
The Avengers,623357910,895455078,1518812988,207438708,4349
The Dark Knight Rises,448139099,632902188,1081041287,160887295,4404
The Hunger Games,408010692,286384032,694394724,152535747,4137
Skyfall,304360277,804200736,1108561013,88364714,3505
The Twilight Saga: Breaking Dawn - Part 2,292324737,537422083,829746820,141067634,4070
The Amazing Spider-Man,262030663,495900000,757930663,62004688,4318
Brave,237283207,301700000,538983207,66323594,4164
The Hobbit: An Unexpected Journey,303003568,714000000,1017003568,84617303,4045
Ted,218815487,330552828,549368315,54415205,3239
Madagascar 3: Europe's Most Wanted,216391482,530529792,746921274,60316738,4258
The Lorax,214030500,134809816,348840316,70217070,3729
Men in Black 3,179020854,445005922,624026776,54592779,4248
Wreck-It Ralph,189422889,281800000,471222889,49038712,3752
Ice Age: Continental Drift,161321843,715922939,877244782,46629259,3881
Snow White and the Huntsman,155332381,241260448,396592829,56217700,3773
Hotel Transylvania,148313048,210062555,358375603,42522194,3349
Taken 2,139854287,236287019,376141306,49514769,3661
21 Jump Street,138447667,63137661,201585328,36302612,3121
Lincoln,182207973,93085477,275293450,944308,11
Prometheus,126477084,276877385,403354469,51050101,3396
Safe House,126373434,81702771,208076205,40172720,3119
The Vow,125014030,71100540,196114570,41202458,2958
Magic Mike,113721571,54017797,167739368,39127170,2930
The Bourne Legacy,113203870,162940880,276144750,38142825,3745
Argo,136025503,96300000,232325503,19458109,3232
Journey 2: The Mysterious Island,103860290,231400000,335260290,27335363,3470
Flight,93772375,68000000,161772375,24900566,1884
Think Like a Man,91547205,4523302,96070507,33636303,2015
Rise of the Guardians,103412758,203528912,306941670,23773465,3653
Mission: Impossible - Ghost Protocol,209397903,485315477,694713380,12785204,425
The Campaign,86907746,18000000,104907746,26588460,3205
Life of Pi,124987023,484029542,609016565,22451514,2927
The Expendables 2,85028192,229947763,314975955,28591370,3316
Wrath of the Titans,83670083,218300000,301970083,33457188,3545
Dark Shadows,79727149,165800000,245527149,29685274,3755
John Carter,73078100,211061000,284139100,30180188,3749
Les Misérables,148809770,293000000,441809770,27281735,2814
Act of Valor,70012847,12484188,82497035,24476632,3039
Django Unchained,162805434,262562804,425368238,30122888,3010
Contraband,66528000,29734212,96262212,24349815,2863
Looper,66486205,110020614,176506819,20801552,2992
Madea's Witness Protection,65653242,1246000,66899242,25390575,2161
Battleship,65422625,237602860,303025485,25534825,3690
Mirror Mirror,64935167,118083355,183018522,18132085,3603
Chronicle,64575175,62060922,126636097,22004098,2907
Pitch Perfect,65001093,50349333,115350426,5149433,335
Hope Springs,63536011,50745040,114281051,14650121,2361
Sherlock Holmes: A Game of Shadows,186848418,357000000,543848418,39637079,3703
Underworld Awakening,62321039,97791632,160112671,25306725,3078
The Lucky One,60457138,38900000,99357138,22518358,3155
The Dictator,59650222,119729311,179379533,17435092,3008
Total Recall,58877969,139589199,198467168,25577758,3601
Titanic,57884114,285666656,343550770,17285453,2674
American Reunion,57011521,177978063,234989584,21514080,3192
ParaNorman,56003051,51136348,107139399,14087050,3429
This Means War,54760791,101730488,156491279,17405930,3189
Project X,54731865,48000000,102731865,21051363,3055
The Woman in Black,54333290,74622608,128955898,20874072,2855
Paranormal Activity 4,53885000,88917657,142802657,29003866,3412
The Devil Inside,53261944,48496546,101758490,33732515,2285
The Girl with the Dragon Tattoo,102515793,130101637,232617430,12768604,2914
The Odd Life of Timothy Green,51854875,4157767,56012642,10822903,2598
Ghost Rider: Spirit of Vengeance,51774002,80789928,132563930,22115334,3174
The Grey,51580236,28201459,79781695,19665101,3185
Red Tails,49876377,489121,50365498,18782154,2512
The Possession,49130154,36315921,85446075,17732480,2816
Diary of a Wimpy Kid: Dog Days,49008662,28221033,77229695,14623599,3391
Sinister,48086903,34428210,82515113,18007634,2527
Beauty and the Beast,47617067,15150762,62767829,17751905,2625
Jack Reacher,80070736,138269859,218340595,15210156,3352
Savages,47382068,35584084,82966152,16016910,2628
The Best Exotic Marigold Hotel,46412041,90424115,136836156,737051,27
Moonrise Kingdom,45512466,22750700,68263166,522996,4
Alvin and the Chipmunks: Chipwrecked,133110742,209584693,342695435,23244744,3723
The Three Stooges,44338224,10481077,54819301,17010125,3477
The Descendants,82584160,94659025,177243185,1190096,29
Here Comes the Boom,45290318,27809854,73100172,11816596,3014
War Horse,79884879,97700000,177584879,7515402,2376
Red Dawn,44806783,6143513,50950296,14276668,2724
Star Wars: Episode I - The Phantom Menace,43456382,59283211,102739593,22469932,2655
Resident Evil: Retribution,42345531,197813724,240159255,21052227,3012
The Cabin in the Woods,42073277,27862323,69935600,14743614,2811
What to Expect When You're Expecting,41152203,43231799,84384002,10547068,3021
Finding Nemo,41128283,50716243,91844526,16687773,2904
End of Watch,41003371,14074775,55078146,13152683,2730
The Artist,44671682,88761174,133432856,204878,4
This Is 40,67544505,20670651,88215156,11579175,2912
We Bought a Zoo,75624550,44457291,120081841,9360434,3117
Rock of Ages,38518613,20900000,59418613,14437269,3470
Abraham Lincoln: Vampire Hunter,37519139,78952441,116471580,16306974,3108
Lawless,37400127,18004032,55404159,10001982,2888
That's My Boy,36931089,20788004,57719093,13453714,3030
Trouble with the Curve,35763137,13200000,48963137,12162040,3212
The Watch,35353000,32914862,68267862,12750297,3168
Step Up Revolution,35074677,105396069,140470746,11731708,2567
Tyler Perry's Good Deeds,35025791,553386,35579177,15583924,2132
Frankenweenie,35291068,46200000,81491068,11412213,3005
Parental Guidance,77267296,42504936,119772232,14554053,3367
The Adventures of Tintin,77591831,296402120,373993951,9720993,3087
2016: Obama's America,33449086,0,33449086,31610,1
House at the End of the Street,31611916,12675215,44287131,12287234,3083
Extremely Loud & Incredibly Close,31847881,23400000,55247881,72348,6
The Pirates! Band of Misfits,31051126,92002915,123054041,11137734,3358
Joyful Noise,30932113,226000,31158113,11225190,2735
The Iron Lady,30017992,85872707,115890699,220409,4
Chimpanzee,28972764,5851000,34823764,10673748,1563
The Five-Year Engagement,28835528,25333835,54169363,10610060,2936
Silver Linings Playbook,132092958,104319495,236412453,443003,16
Cloud Atlas,27108272,103374596,130482868,9612247,2008
One for the Money,26414527,11666262,38080789,11515790,2737
Alex Cross,25888412,8730455,34618867,11396768,2539
Katy Perry: Part of Me,25326071,7400885,32726956,7138266,2730
Hugo,73864507,111905653,185770160,11364505,1277
Sparkle,24397469,240331,24637800,11643342,2244
The Guilt Trip,37134215,4729511,41863726,5290629,2431
Tinker Tailor Soldier Spy,24149393,57095212,81244605,310562,4
Premium Rush,20275446,10808153,31083599,6030164,2255
Big Miracle,20157300,4561915,24719215,7760205,2129
"Monsters, Inc.",34043006,16164814,50207820,4774686,2618
The Secret World of Arrietty,19202743,129597531,148800274,6446395,1522
Haywire,18942396,15571364,34513760,8425370,2439
Man on a Ledge,18620000,29016031,47636031,8001932,2998
A Thousand Words,18450127,2353715,20803842,6176280,1890
Chernobyl Diaries,18119640,20270380,38390020,7955307,2433
Silent Hill: Revelation,17529157,37833548,55362705,8023036,2933
Wanderlust,17450535,6362281,23812816,6526650,2002
The Perks of Being a Wallflower,17742948,15641179,33384127,228359,4
Safe,17142080,24422590,41564670,7892539,2266
To Rome With Love,16685867,56559014,73244881,361359,5
The Raven,16008272,13691073,29699345,7289642,2203
The Master,16377274,11880786,28258060,736311,5
The Man with the Iron Fists,15634090,4912428,20546518,7910980,1868
Seven Psychopaths,15024049,17202333,32226382,4174915,1480
Killing Them Softly,15026056,22904409,37930465,6812900,2424
Lockout,14326864,18621249,32948113,6231836,2308
Hit and Run,13749300,3067347,16816647,4526222,2870
Dredd,13414714,27623028,41037742,6278491,2506
Silent House,12754783,3772964,16527747,6661234,2124
Playing for Keeps,13103272,17859063,30962335,5750288,2837
People Like Us,12434778,124153,12558931,4255423,2055
Gone,11682205,8085330,19767535,4770360,2186
The Words,11494838,4455326,15950164,4750894,2801
Beasts of the Southern Wild,12795746,8312000,21107746,169702,4
Anna Karenina,12816367,56112783,68929150,320690,16
To the Arctic 3D,14560838,9134550,23695388,270228,50
New Year's Eve,54544638,87500000,142044638,13019180,3505
The Intouchables,10198820,416389690,426588510,103507,4
The Darkest Hour,21443494,43183292,64626786,2993519,2324
Fun Size,9409538,2007824,11417362,4101017,3014
Bernie,9206470,884171,10090641,85805,3
Salmon Fishing in the Yemen,9047981,25516670,34564651,225894,18
Cirque du Soleil: Worlds Away,12512862,21640239,34153101,2162993,840
Arbitrage,7919574,27565482,35485056,2002165,197
Friends with Kids,7251073,5768000,13019073,2019083,369
Seeking a Friend for the End of the World,7078738,4603043,11681781,3822803,1625
A Separation,7099055,15827021,22926076,59481,3
The Collection,6842058,3087648,9929706,3104269,1403
The Muppets,88631237,76553000,165184237,29239026,3440
Born to Be Wild,25978556,15665919,41644475,871478,206
The Twilight Saga: Breaking Dawn - Part 1,281287133,430918723,712205856,138122261,4061
My Week with Marilyn,14600347,20457349,35057696,1750507,244
Chasing Mavericks,6002756,1939360,7942116,2268274,2002
Casa de mi Padre,5909483,2537469,8446952,2287239,382
For Greater Glory: The True Story of Cristiada,5672846,4500836,10173682,1885608,757
The Sessions,6002451,4653704,10656155,113467,4
Won't Back Down,5310554,67674,5378228,2603370,2515
Hubble 3D,52522904,21726825,74249729,413477,39
October Baby,5157886,0,5157886,1718000,390
Hitchcock,6008677,21030992,27039669,287715,17
Young Adult,16311571,6627456,22939027,310263,8
The Apparition,4936819,6413846,11350665,2841488,810
The Sitter,30441326,4500862,34942188,9851435,2750
A Dangerous Method,5704709,24814727,30519436,167953,4
"Jeff, Who Lives at Home",4269426,435331,4704757,855709,254
Goon,4168528,2816630,6985158,1232860,241
The Raid: Redemption,4105187,5043332,9148519,213785,14
Safety Not Guaranteed,4010957,413742,4424699,97762,9
Puss in Boots,149260504,405726973,554987477,34077439,3952
Bully,3863446,86798,3950244,535433,158
Flying Monsters 3D with David Attenborough,5705874,5107988,10813862,0,0
The Cold Light of Day,3763583,13100000,16863583,1831588,1511
Nitro Circus: The Movie,3377618,796651,4174269,1183701,800
Atlas Shrugged II: The Strike,3336053,0,3336053,1751572,1012
Last Ounce of Courage,3329674,0,3329674,1708000,1407
Pina,3524826,15181027,18705853,68012,3
Happy Feet Two,64006466,95189793,159196259,21237068,3606
Robot & Frank,3325038,1481385,4806423,35539,2
Raiders of the Lost Ark,3125613,207241,3332854,1673731,267
Celeste & Jesse Forever,3094813,546162,3640975,107785,4
Jab Tak Hai Jaan,3047539,3655575,6703114,1283585,161
Albert Nobbs,3014696,4517563,7532259,696088,245
Searching for Sugar Man,3696196,5426210,9122406,27459,3
Talaash,2871956,2405810,5277766,1638706,172
Barfi!,2804874,1685260,4490134,1061713,132
Singin' in the Rain,1608925,864,1609789,0,0
Samsara,2672413,1754031,4426444,76222,2
Girl in Progress,2609412,2099834,4709246,1384078,322
Jiro Dreams of Sushi,2552478,140386,2692864,42035,2
Ruby Sparks,2540106,6588157,9128263,140822,13
Jack and Jill,74158157,75515631,149673788,25003575,3438
The Queen of Versailles,2401999,93707,2495706,51326,3
Ek Tha Tiger,2347774,3195343,5543117,1139340,120
Sleepwalk with Me,2266067,0,2266067,68801,1
Carnage,2547047,28175585,30722632,79795,5
Space Station 3D,93383953,34979928,128363881,489488,24
Under the Sea 3D,36262926,19639698,55902624,661185,49
Fearless 2,2519190,1697798,4216988,1019213,166
Shame,3909002,15214765,19123767,361000,10
Monsieur Lazhar,2009517,7065194,9074711,112190,19
Footnote,2007758,443501,2451259,47528,2
Casablanca,1155330,71478,1226808,950000,0
Killer Joe,1987762,2645906,4633668,37900,3
Agneepath,1986748,1595698,3582446,1140464,132
Hyde Park on Hudson,6376145,4604336,10980481,81362,4
English Vinglish,1862086,1202732,3064818,745414,88
Crooked Arrows,1832541,0,1832541,257364,55
Hysteria,1804139,7780117,9584256,35656,5
The Oscar Nominated Short Films 2012: Live Action,1702415,0,1702415,412304,120
We Need to Talk About Kevin,1738692,7493626,9232318,24587,1
Sea Rex 3D: Journey to a Prehistoric World,6096582,9907568,16004150,5000000,0
Your Sister's Sister,1636190,1606612,3242802,109221,13
"Farewell, My Queen",1597998,4768837,6366835,72100,4
Housefull 2,1791780,2243310,4035090,847132,121
Take This Waltz,1239692,3726258,4965950,137019,30
The Dark Knight,1513086,23387683,24900769,185000000,0
Batman Begins,1508658,6317744,7826402,150000000,0
Zero Dark Thirty,95720716,37100000,132820716,417150,5
Marley,1413480,2429439,3842919,262004,42
Tower Heist,78046570,74884053,152930623,24025190,3367
The Kid with a Bike,1470000,5541798,7011798,45933,3
A Late Quartet,1562548,4741161,6303709,75279,9
"For a Good Time, Call...",1251749,134339,1386088,143935,23
Cocktail,1227789,1496906,2724695,647956,96
Speak Bachchan,1216258,27559004,28775262,561996,98
Woman Thou Art Loosed: On the 7th Day,1213128,0,1213128,641542,102
Headhunters,1200010,17762434,18962444,43013,4
The Other Son,1285918,2534487,3820405,125691,41
Ek Main Aur Ekk Tu,1155545,1138278,2293823,637100,111
The Deep Blue Sea,1126525,1989084,3115609,123841,31
Real Steel,85468508,213800000,299268508,27319677,3440
The Oogieloves in the Big Balloon Adventure,1065907,0,1065907,443901,2160
In Darkness,1041455,8620304,9661759,27413,3
First Position,1014071,716753,1730824,48024,5
Damsels in Distress,1008455,305903,1314358,58589,4
Unconditional,1005800,28648,1034448,525192,312
Rampart,972512,571101,1543613,60446,5
Diana Vreeland: The Eye Has to Travel,1017579,703893,1721472,63700,3
Masquerade,922921,93345511,94268432,0,0
Immortals,83504017,143400000,226904017,32206425,3112
The Imposter,898317,2103560,3001877,22379,1
Deep Sea,46412757,51818148,98230905,700213,43
J. Edgar,37306030,47614509,84920539,11217324,1910
Arthur Christmas,46462469,100957003,147419472,12068931,3376
Darling Companion,793815,363442,1157257,39962,4
Thin Ice,790421,0,790421,183527,53
Teri Meri Kahaani,781196,793507,1574703,405926,94
Chasing Ice,1328467,30201,1358668,0,0
Rowdy Rathore,777373,28565090,29342463,381784,120
Son of Sardaar,771789,846572,1618361,341552,109
Bill W.,809590,0,809590,0,0
Cosmopolis,763556,6265539,7029095,70339,3
Coriolanus,757195,1678130,2435325,61136,9
Don 2,3680306,3233212,6913518,1673921,157
Pariah,769552,0,769552,48579,4
Agent Vinod,698210,663261,1361471,427043,122
The Paperboy,693286,3090579,3783865,102706,11
The Thieves,685839,86440528,87126367,136993,11
Student of the Year,670086,667195,1337281,326508,106
The Polar Express,669289,0,669289,73514,15
2 Days in New York,633210,3424903,4058113,23942,2
A Royal Affair,1546761,13212236,14758997,38212,7
Moneyball,75605492,34600724,110206216,19501302,2993
Rust and Bone,2062027,23745685,25807712,27154,2
Heroine,598668,7438185,8036853,389901,114
Blue Like Jazz,595018,0,595018,261190,136
"Peace, Love & Misunderstanding",590700,514320,1105020,105960,31
Thunderstruck,587211,0,587211,0,0
W.E.,583455,1458748,2042203,47074,4
Undefeated,562218,21626,583844,33165,5
Vicky Donor,549001,190084,739085,169209,50
We Have a Pope,548115,17329408,17877523,31368,3
Being Flynn,540152,442972,983124,43990,4
Melancholia,3030848,14008966,17039814,257174,19
Ai Weiwei: Never Sorry,534100,347561,881661,41104,5
Where Do We Go Now?,531997,6975011,7507008,15382,3
The Impossible,19019882,179067330,198087212,143818,15
Holy Motors,641100,1313025,1954125,18866,2
Shut Up and Play the Hits,510334,118773,629107,0,0
In Time,37520095,136410501,173930596,12050368,3122
Courageous,34522221,663663,35185884,9112839,1161
The Flat,471842,111601,583443,19916,3
"Bless Me, Ultima",1561962,0,1561962,470109,263
Bachelorette,447954,11680621,12128575,181494,47
Midnight in Paris,56817045,97142545,153959590,599003,6
Ferrari Ki Sawaari,434107,255754,689861,240792,99
Seeking Justice,411746,13677782,14089528,249912,231
Sound of My Voice,408015,16073,424088,36134,5
The Well Digger's Daughter,386368,12807799,13194167,10273,3
Khiladi 786,379466,455629,835095,228967,115
Piranha 3DD,376512,8117216,8493728,182237,86
Smashed,376597,123128,499725,26943,4
Detropia,390024,0,390024,17414,1
The Oranges,366377,1950594,2316971,198461,110
Dolphin Tale,72286779,23645786,95932565,19152401,3507
Branded,353513,3874471,4227984,240589,307
Chico & Rita,350524,1997395,2347919,20654,1
Red Hook Summer,338803,0,338803,40070,4
A Werewolf Boy,342922,45939666,46282588,0,0
Liberal Arts,327345,823336,1150681,27435,4
Air Racers,1309987,0,1309987,0,0
Compliance,319285,272831,592116,16427,1
The Salt of Life,317405,2533447,2850852,19176,2
The Flowers of War,311434,2544210,2855644,48448,30
A Cat in Paris,309973,1770661,2080634,34554,6
Love,309200,1224674,1533874,83178,7
Back to 1942,312954,605533,918487,105702,20
Stolen,304318,17111100,17415418,183125,141
Something from Nothing: The Art of Rap,288000,45388,333388,150337,157
Bully,279202,182203,461405,116472,5
Burn,996103,0,996103,0,0
The Way,4430765,4007107,8437872,110418,33
The Women on the 6th Floor,719823,26814147,27533970,26200,6
In the Land of Blood and Honey,303877,899822,1203699,18854,3
Love in the Buff,256451,3788930,4045381,91233,10
Boy,256211,43294943,43551154,21244,2
Chicken With Plums,253874,3012067,3265941,11301,2
Lola Versus,252603,203151,455754,31815,4
Keep the Lights On,246112,142219,388331,55574,5
My Uncle Rafael,243616,0,243616,109747,14
Gerhard Richter Painting,242646,470542,713188,13537,1
Trishna,240381,727291,967672,29140,3
Drive,35061555,41915111,76976666,11340461,2886
Middle of Nowhere,236806,0,236806,67909,6
Elena,233380,1994525,2227905,9035,1
The Central Park Five,325653,0,325653,30570,3
Tezz,229931,175283,405214,148133,97
Amour,6739492,22912688,29652180,68266,3
The Help,169708112,46931000,216639112,26044590,2534
Promised Land,7597898,3441133,11039031,173915,25
The Viral Factor,220496,5466823,5687319,63235,22
Thaandavam,213476,0,213476,129044,45
Neil Young Journeys,215026,6056,221082,12025,3
Tai ji 1: Cong ling kai shi,212094,1059427,1271521,85094,31
Polisse,211440,20379432,20590872,16568,3
The Awakening,209696,6669971,6879667,95933,70
A Very Harold & Kumar Christmas,35061031,1131744,36192775,12954142,2875
Little White Lies,206088,53113527,53319615,25654,3
Vettai,204373,483263,687636,87921,34
Touchback,204232,0,204232,66998,50
10 Years,203373,74963,278336,22707,3
Tim and Eric's Billion Dollar Movie,201436,22144,223580,87475,24
Brooklyn Castle,219407,0,219407,18761,2
Barbara,1013902,5875283,6889185,63410,15
A Simple Life,191826,4471268,4663094,43372,9
Easy Money,205741,8164015,8369756,24684,2
Footloose,51802742,11740586,63543328,15556113,3549
The House I Live In,210752,8407,219159,16453,2
Somewhere Between,210975,0,210975,7799,1
Lost Woods,180117,0,180117,58240,13
Fullmetal Alchemist: The Sacred Star of Milos,177802,7443562,7621364,119300,42
Tere Naal Love Ho Gaya,177743,304053,481796,94583,49
Monumental: In Search of America's National Treasure,177729,0,177729,28340,6
The Hunter,176669,1504109,1680778,19032,4
The Waiting Room,244951,0,244951,7086,4
Le Havre,611709,12347997,12959706,26363,6
Grand Illusion,174065,0,174065,7526,1
Battlefield America,172000,80805,252805,113882,188
Flying Swords of Dragon Gate,170276,3153105,3323381,95452,15
Joker,169181,321110,490291,105366,74
Dark Horse,166228,170922,337150,13551,1
The Big Picture,158411,0,158411,13760,2
Elles,157508,3664733,3822241,24286,6
Crazy Horse,157782,0,157782,7963,1
Deadtime,156072,0,156072,30240,18
Shirin Farhad Ki Toh Nikal Padi,155758,114087,269845,119743,54
Unforgivable,154189,1196957,1351146,27857,5
Once Upon a Time in Anatolia,152408,1947064,2099472,10952,1
The Skin I Live In,3185812,30492594,33678406,223119,6
Bullhead,151840,4331307,4483147,32267,7
Chakravyuh,151778,78358,230136,97896,79
Made In Mexico,151133,891540,1042673,76123,12
Simon and the Oaks,150664,4354909,4505573,9964,1
Deadly Renovations,146146,0,146146,42588,13
I Wish,145808,2225740,2371548,10919,5
From Beneath,144123,0,144123,47628,18
This Must Be the Place,143979,11784930,11928909,7754,2
Luv Shuv Tey Chicken Khurana,143507,85629,229136,95364,60
High School,139034,82556,221590,82832,200
Beloved,137515,1834343,1971858,25825,5
Slaughter Creek,136815,0,136815,49392,16
Warriors of the Rainbow: Seediq Bale I,136166,4534266,4670432,57183,12
The Other Dream Team,135228,0,135228,19821,2
How to Survive a Plague,132055,0,132055,28250,4
Kumaré,132160,0,132160,9601,1
Puella Magi Madoka Magica the Movie Part 1: Beginnings,180440,5635890,5816330,62340,5
The Loneliest Planet,129579,139354,268933,15689,2
The Forgiveness of Blood,126700,28683,155383,26724,3
"Turn Me On, Dammit!",126085,1617658,1743743,10145,2
The Ides of March,40962534,35375577,76338111,10470143,2199
God Bless America,122550,271330,393880,27308,14
Iron Sky,122082,9987577,10109659,0,0
Cowgirls 'n Angels,120680,0,120680,54675,50
Bel Ami,120462,9254470,9374932,38018,15
The Bullet Vanishes,117629,1410951,1528580,43444,14
Margin Call,5354039,14150000,19504039,561906,56
La femme du Vème,113800,545969,659769,33011,9
Burn,113173,0,113173,1970,1
Follow Me: The Yoni Netanyahu Story,112679,0,112679,7882,1
Not Fade Away,610792,25607,636399,19182,3
"Wild Horse, Wild Ride",111205,0,111205,3610,1
The Obama Effect,110904,0,110904,83896,25
Any Day Now,201395,60352,261747,40489,16
The Perfect Family,110313,0,110313,14300,5
Hello I Must Be Going,106709,248230,354939,23904,2
Butter,105018,70688,175706,70931,90
The Magic of Belle Isle,102388,21433,123821,10367,4
"Oslo, August 31st",101475,1284903,1386378,9564,2
Mugamoodi,101000,30965,131965,55501,21
Wuthering Heights,100915,1641300,1742215,8956,1
V/H/S,100345,1843942,1944287,36402,16
360,100343,4296632,4396975,12186,2
Sister,154659,1063515,1218174,15401,3
Hardflip,96734,0,96734,49879,22
Goodbye First Love,95000,419913,514913,21077,4
The Road,92476,849565,942041,56692,50
In the Family,101934,0,101934,0,0
Marina Abramovic: The Artist Is Present,86637,70058,156695,11041,2
Escape Fire: The Fight to Rescue American Healthcare,126238,0,126238,30953,12
The Eye of the Storm,83566,2021123,2104689,25785,7
Hating Breitbart,81432,0,81432,40673,4
T-Rex: Back to the Cretaceous,53354743,50605624,103960367,0,0
Starlet,88212,58010,146222,15662,6
The Innkeepers,78396,1091354,1169750,29557,25
The Island President,76398,4598,80996,13998,2
Hara-Kiri: Death of a Samurai,75688,5359670,5435358,10920,2
5 Broken Cameras,109983,36492,146475,6674,1
This Is Not a Film,77016,11742,88758,12608,5
On the Ice,73492,0,73492,17901,4
Detachment,72689,1608832,1681521,10739,2
Runaway Slave,71737,0,71737,3626,1
My Way,70177,16583311,16653488,17817,22
On the Road,744296,8873081,9617377,39550,4
Taur Mittran Di,69510,11369,80879,49926,24
An Inconsistent Truth,69394,0,69394,20733,1
Intruders,69136,5278913,5348049,40746,33
Klown,68795,0,68795,19683,3
Toys in the Attic,64918,0,64918,19913,27
Girlfriend Boyfriend,64414,603212,667626,29016,16
The Details,63595,0,63595,18528,14
Take Shelter,1730296,2010802,3741098,52041,3
Let the Bullets Fly,63012,104660302,104723314,11287,5
The Invisible War,71968,0,71968,16500,4
Being Elmo: A Puppeteer's Journey,304052,6760,310812,22963,1
Sholem Aleichem: Laughing in the Darkness,906666,0,906666,20247,1
Young Goethe in Love,162138,5664427,5826565,17143,6
Deadfall,66351,1879903,1946254,19391,11
Backwards,61465,0,61465,23190,5
The Bodyguard,61020,0,61020,0,0
Declaration of War,59100,7632510,7691610,12791,6
Vulgaria,59059,3969484,4028543,31097,16
Side by Side,58825,8229,67054,6956,1
Paranormal Activity 3,104028807,103011037,207039844,52568183,3321
Beyond the Black Rainbow,56491,0,56491,4957,2
The Turin Horse,56391,105697,162088,9145,1
Free Men,53810,1138841,1192651,0,0
Natural Selection,55282,0,55282,10375,1
A Beautiful Soul,54008,0,54008,46410,20
Wi-heom-han gyan-gye,54000,2020864,2074864,18027,6
Surviving Progress,53953,0,53953,4161,2
The Extraordinary Voyage,52986,6438,59424,2915,3
Occupy Unmasked,52768,0,52768,40952,4
Red Lights,52624,14054689,14107313,10340,2
Jodi Breakers,52618,25406,78024,52618,45
Beware of Mr. Baker,116476,93647,210123,12195,1
Painted Skin: The Resurrection,50425,2404934,2455359,17791,6
Wake in Fright,50394,0,50394,6761,1
The Fitzgerald Family Christmas,50292,0,50292,13800,4
Union Square,44830,0,44830,14406,4
Neighboring Sounds,60255,404827,465082,12666,2
"All's Well, Ends Well 2012",47919,3342313,3390232,23250,20
War of the Buttons,47771,15034638,15082409,4737,5
Sing Your Song,47718,17592,65310,13459,2
Ballplayer: Pelotero,46109,0,46109,20628,10
The Pruitt-Igoe Myth,44883,0,44883,4721,1
Double Trouble,44788,276293,321081,17978,12
"OC87: The Obsessive Compulsive, Major Depression, Bipolar, Asperger's Movie",43583,0,43583,5733,1
Entre les Bras,47439,0,47439,5643,2
The Graduate,43466,0,43466,5778,1
Nobody Else But You,43040,107133,150173,3759,2
Last Call at the Oasis,42423,0,42423,8899,3
The Mill and the Cross,312187,803993,1116180,11354,1
Fat Kid Rules the World,41000,0,41000,1450,1
The Comedy,41113,0,41113,6000,1
The FP,40557,0,40557,15465,28
Paan Singh Tomar,40311,0,40311,20568,10
Crazy Wisdom: The Life & Times of Chogyam Trungpa Rinpoche,86202,0,86202,10304,1
My Reincarnation,92822,3293,96115,6498,1
Soldiers of Fortune,38898,1745388,1784286,24978,50
Paul Williams Still Alive,38691,0,38691,6116,1
All Together,43180,8792723,8835903,12887,10
Death by China,38492,0,38492,5701,1
The Fairy,38399,91419,129818,4199,2
Children of Paradise,36986,0,36986,10741,2
Mansome,36280,0,36280,18395,20
The Inbetweeners,36000,88787111,88823111,36000,10
Bangkok Revenge,35784,0,35784,22116,22
Conquest 1453,35730,35761315,35797045,35730,4
El Bulli: Cooking in Progress,237181,105935,343116,12756,1
Comic-Con Episode IV: A Fan's Hope,34665,0,34665,8203,3
Hit So Hard,34025,2551,36576,6500,1
Tomboy,129834,1307667,1437501,7078,1
The Conquest,74474,6562692,6637166,16273,6
Addiction Incorporated,40106,0,40106,1629,1
District of Corruption,31954,0,31954,25086,3
Musical Chairs,31478,0,31478,9092,9
Celine and Julie Go Boating,31452,0,31452,5624,1
Whores' Glory,31420,166512,197932,5358,3
Kalakalappu,30949,10675,41624,17101,10
Life Happens,30905,17136,48041,20186,16
The Bay,30668,1550584,1581252,19747,23
Hide Away,30655,0,30655,689,1
Like Crazy,3395391,336098,3731489,123140,4
Gregory Crewdson: Brief Encounters,60064,0,60064,1492,1
Brother,29864,0,29864,18835,49
Sacrifice,29792,29063768,29093560,15243,11
Meet the Fokkens,30810,0,30810,7628,1
You've Been Trumped,29273,35947,65220,4497,1
Wagner & Me,37745,16470,54215,4891,2
Max and the Junkmen,35387,0,35387,11264,1
Kill List,29063,421212,450275,9838,2
The Ambassador,28102,0,28102,13046,4
Least Among Saints,28026,0,28026,15774,3
Galapagos,18630372,10718800,29349172,0,0
Here,26743,4685,31428,7927,1
"Pink Ribbons, Inc.",26608,0,26608,2721,3
Mozart's Sister,707885,1117006,1824891,34046,7
"The Devil, Probably",26816,0,26816,1688,1
The Guard,5360274,14201630,19561904,76834,4
Nobody Walks,25342,0,25342,7269,2
Death of the Virgin,25247,0,25247,8628,3
Orchestra of Exiles,34577,0,34577,6719,1
Sound of Noise,24565,431801,456366,5877,3
Otter 501,24449,0,24449,5444,3
Attenberg,24036,110467,134503,3998,1
North Sea Texas,28307,0,28307,4487,3
Hellbound?,22887,0,22887,3938,4
The First Time,22836,69818,92654,17061,19
Keyhole,22826,0,22826,3294,1
Carol Channing: Larger Than Life,22740,0,22740,5000,2
The Long Day Closes,22765,0,22765,1407,1
Losing Control,22081,0,22081,2196,1
West of Memphis,310154,8163,318317,13360,5
The Whale,81881,0,81881,4835,2
Better Than Something: Jay Reatard,21697,0,21697,5712,4
Sedona,21638,0,21638,0,0
Waiting for Lightning,21577,0,21577,19537,11
Bonsai,21267,27861,49128,2293,1
Girl Model,21154,1215,22369,4898,1
Lay the Favorite,20998,1555689,1576687,20998,61
The Day,20984,3702,24686,10121,12
The Greatest Miracle,555166,2464216,3019382,35768,13
The Highest Pass,20386,0,20386,10125,2
Ranchero,24036,0,24036,3826,2
Magnificent Desolation: Walking on the Moon 3D,34137524,6201878,40339402,479587,80
Jesus Henry Christ,20183,0,20183,8192,3
How to Grow a Band,20135,0,20135,5705,1
Radio Unnameable,24090,0,24090,5833,1
In Over My Head,19482,0,19482,7476,1
Steve Jobs: The Lost Interview,105710,21831,127541,0,0
Sophomore,18945,0,18945,13097,1
28 Hotel Rooms,18869,112339,131208,1869,1
The Iran Job,23115,0,23115,4295,1
Wish Me Away,18618,0,18618,5026,3
The Revisionaries,22664,0,22664,2608,1
Lovely Molly,18464,256016,274480,12555,5
Marcelino Pan y Vino,18193,0,18193,17092,1
The Color Wheel,19001,0,19001,3884,2
Total Recall,18081,0,18081,5788,1
Juan of the Dead,18000,306834,324834,12000,1
Payback,17979,0,17979,2186,1
4:44 Last Day on Earth,17801,53050,70851,8355,3
Little Birds,17739,0,17739,4574,1
Eames: The Architect & The Painter,153088,6627,159715,0,0
Grandmaster,17077,0,17077,10479,9
Port of Shadows,27389,12234,39623,6618,1
The Understudy,17036,0,17036,0,0
The Prophet's Son,16983,0,16983,8168,1
The Bride Wore Black,44566,0,44566,6463,1
Inventing Our Life: The Kibbutz Experiment,16734,0,16734,6193,1
Return,16124,762,16886,6717,3
Long Shot: The Kevin Laue Story,16011,0,16011,16011,1
Supercapitalist,16000,0,16000,8372,1
10 timer til Paradis,16000,5561,21561,5388,2
Patience,15941,30469,46410,5302,1
This Binary Universe,15875,0,15875,1794,2
Take Me Home,15760,0,15760,322,1
Michael,15715,105319,121034,3366,1
Quill: The Life of a Guide Dog,15674,46000,61674,1678,2
Alps,16057,127177,143234,2628,2
A Little Bit of Heaven,15375,6763013,6778388,10011,11
Elite Squad 2: The Enemy Within,100119,63518731,63618850,8648,1
"The Man Nobody Knew: In Search of My Father, CIA Spymaster William Colby",183342,0,183342,15411,1
17 Girls,15123,434503,449626,4449,10
Kung Fu Joe,15120,0,15120,3158,2
Trade of Innocents,15091,0,15091,588,1
30 Beats,14693,0,14693,8624,15
The Outrage,44745,8412996,8457741,6518,2
Unraveled,14615,0,14615,9006,2
Tristana,14586,0,14586,4754,1
Silent Night,14567,112027,126594,9780,11
Space Dogs,14408,8515818,8530226,14408,5
Never Stand Still,14272,0,14272,1951,1
Gayby,14062,0,14062,4792,1
6 Month Rule,14057,0,14057,1963,1
Head Games,14056,0,14056,1152,2
Falling Away,13869,0,13869,1284,2
Lost Bohemia,23584,0,23584,0,0
Daisies,13692,0,13692,6576,1
Planet of Snail,13957,2045,16002,2011,1
Reuniting the Rubins,13569,5719,19288,734,2
Dysfunctional Friends,13546,0,13546,7409,2
Blackthorn,200558,787325,987883,15254,8
Django,25916,0,25916,6150,8
The Day He Arrives,13746,308602,322348,3311,1
The Trouble with Bliss,13093,0,13093,4618,1
"How Much Does Your Building Weigh, Mr Foster?",13013,0,13013,2759,1
Norwegian Wood,13000,19102721,19115721,13000,3
Citadel,13377,128509,141886,5715,1
California Solo,15433,0,15433,3412,1
We Won't Grow Old Together,14104,0,14104,1677,1
Virginia,12728,0,12728,6915,5
For Ellen,12396,8350,20746,4616,1
Grassroots,12356,7136,19492,6497,1
Lost Angels: Skid Row Is My Home,12025,0,12025,7039,1
Khodorkovsky,39522,255077,294599,6110,1
Shanghai Red,30353,0,30353,3008,1
Ultrasuede: In Search of Halston,11539,0,11539,3968,1
The Law in These Parts,13683,0,13683,2814,1
Dragon,11137,130892,142029,11137,14
The Front Line,11018,20618627,20629645,7188,6
The Lion King,94242001,91300000,185542001,30151614,2330
Tales of the Night,10975,1751219,1762194,7154,1
Wallander: Hämnden,10960,0,10960,2230,1
Special Forces,10759,3413889,3424648,10759,5
My Worst Nightmare,21952,8204592,8226544,1142,1
Found Memories,10575,30154,40729,3874,1
China Heavyweight,10550,0,10550,3792,1
Starry Starry Night,10033,579266,589299,2312,2
Santa Mesa,10490,0,10490,3846,3
Paul Goodman Changed My Life,35671,0,35671,5754,1
Husbands in Goa,10135,2453,12588,4483,7
Arjun: The Warrior Prince,10017,0,10017,5527,10
The Do-Deca-Pentathlon,10000,0,10000,10000,8
Garbo: El espía,28563,0,28563,5593,1
Post Mortem,9750,276952,286702,2406,1
In Another Country,25079,586286,611365,3207,1
[REC] 3: Genesis,9600,10989067,10998667,3001,8
"Now, Forager",11146,0,11146,1539,1
Around June,12578,0,12578,0,0
When the Iron Bird Flies: Tibetan Buddhism Arrives in the West,13598,0,13598,0,0
The City Dark,9269,0,9269,2983,1
Putin's Kiss,10082,0,10082,1525,1
Decoding Deepak,9100,0,9100,9100,3
Money Fight,9004,0,9004,8759,1
Mosquita y Mari,9000,0,9000,5070,1
Three Stars,8942,0,8942,1003,1
Corpo Celeste,8919,307585,316504,2263,1
Home Run Showdown,8824,0,8824,8824,1
Man on a Mission: Richard Garriott's Road to the Stars,8688,0,8688,3430,4
"Small, Beautifully Moving Parts",8631,0,8631,3087,1
General Education,8601,0,8601,282,1
Letters to Elena,8511,112743,121254,7711,12
The Snowtown Murders,8452,1340935,1349387,1273,1
Dreams of a Life,8405,283493,291898,3085,1
Over Your Cities Grass Will Grow,51301,18955,70256,7272,1
Cook County,17977,0,17977,7579,5
The Interrupters,282448,4009,286457,7920,1
The Autobiography of Nicolae Ceausescu,34023,33070,67093,4644,1
Restless City,8100,0,8100,8100,3
The Babymakers,7889,467622,475511,5215,11
Roadie,7825,0,7825,2661,1
Photographic Memory,7822,0,7822,3006,2
Last Days Here,7643,0,7643,2671,1
Brooklyn Brothers Beat the Best,7466,744,8210,3850,1
Bel Borba Aqui,7426,0,7426,1869,1
Price Check,7413,0,7413,2783,1
The Man in the White Suit,8718,0,8718,3874,1
The Giant Mechanical Man,7396,0,7396,1789,1
Domain,7105,0,7105,2810,1
The Rabbi's Cat,23392,4185181,4208573,4301,1
"Love, Marilyn",6950,0,6950,4000,1
Hitler's Children,28663,0,28663,2939,1
Last Ride,6853,0,6853,838,1
The Look,19988,63149,83137,5905,2
Prince of the Himalayas,10190,0,10190,0,0
Nothing But a Man,13063,0,13063,3466,1
In Our Nature,6543,0,6543,4378,1
Granito,43942,0,43942,4330,1
Windfall,6504,0,6504,1780,1
The Beat Hotel,6480,0,6480,1458,1
Film socialisme,42925,79339,122264,4526,1
The Polar Express,711168,0,711168,55299,19
Tonight You're Mine,6255,126532,132787,2144,2
Tyrannosaur,22321,653790,676111,7635,5
Sigur Rós: Inni,123482,0,123482,14903,3
Crazy Eyes,6141,0,6141,3259,2
The Last Fall,6100,0,6100,6100,1
The Miners' Hymns,6051,0,6051,3217,1
Tchoupitoulas,19375,0,19375,2379,1
Las Acacias,6000,348391,354391,6000,1
Hell and Back Again,40634,315,40949,3413,1
American Animal,5928,0,5928,5928,1
BuzzKill,5860,0,5860,2912,1
The Man Who Shook the Hand of Vicente Fernandez,10782,0,10782,3099,1
Save the Date,5719,0,5719,3755,2
Booker's Place: A Mississippi Story,5549,0,5549,2455,2
Young & Wild,5514,207110,212624,3798,2
Universal Soldier: Day of Reckoning,5460,1396847,1402307,3181,3
The Good Doctor,5206,45811,51017,3180,2
A Liar's Autobiography: The Untrue Story of Monty Python's Graham Chapman,5102,58367,63469,5102,4
Nostalgia for the Light,163962,13672,177634,5664,1
Downtown Express,5010,0,5010,3474,1
Newlyweds,5000,0,5000,4584,1
Bringing Up Bobby,4975,0,4975,1005,1
Miss Minoes,10189,0,10189,1901,3
"Tomorrow, When the War Began",4936,16528659,16533595,3172,10
The Worst Movie Ever!,25206,0,25206,11,1
Brake,4876,97943,102819,4330,2
King of Devil's Island,7615,4352776,4360391,1039,1
CornerStore,45176,0,45176,12743,1
Jane's Journey,27253,190362,217615,6193,1
Sushi: The Global Catch,5757,0,5757,516,1
Oka!,18364,0,18364,4461,1
Art Is... The Permanent Revolution,4291,0,4291,2718,1
Summer,43839,0,43839,4957,1
Amigo,184705,0,184705,37324,10
Only the Young,15312,0,15312,1446,1
Pickin' & Grinnin',4000,0,4000,3003,1
Yangsi,4008,0,4008,0,0
Breathing,4630,802806,807436,949,1
The Moth Diaries,3838,409197,413035,2276,2
They Come to America,3775,0,3775,3775,1
Bad Blood,3731,0,3731,1872,10
Free Radicals: A History of Experimental Film,3804,0,3804,1350,1
The Day I Saw Your Heart,3546,29021,32567,2810,1
Loosies,3519,32626,36145,808,1
A Man Vanishes,6201,0,6201,1576,2
Cirkus Columbia,3457,169626,173083,1284,1
Scorn,2206,0,2206,0,0
Vamps,3361,89387,92748,548,1
Sleepless Night,3358,621555,624913,2106,2
"El Sicario, Room 164",6123,0,6123,2040,1
Terkel in Trouble,40385,0,40385,3972,2
Rid of Me,11740,0,11740,2070,1
After the Wizard,3184,0,3184,2527,2
Apart,3161,0,3161,3161,2
ATM,3010,918742,921752,2034,2
About Cherry,3003,5312,8315,2760,3
Le Amiche,68167,0,68167,10092,1
Perfect Sense,2959,930393,933352,1567,1
Four Adventures of Reinette and Mirabelle,22039,0,22039,5051,1
Cheerful Weather for the Wedding,2651,168271,170922,727,1
Carl,2592,0,2592,2592,1
Pianomania,49852,243018,292870,2238,1
The Samaritan,2521,12699,15220,1744,3
Why Stop Now?,2432,0,2432,1641,3
The Heir Apparent: Largo Winch,10352,43441,53793,2830,4
Gainsbourg: A Heroic Life,233007,11987449,12220456,25189,3
See What I'm Saying: The Deaf Entertainers Documentary,118206,0,118206,4996,1
Patagonia Rising,2064,0,2064,981,1
London River,7200,0,7200,1044,1
Split: A Deeper Divide,2000,0,2000,2338,1
The Night Watchman,2219,0,2219,378,2
Mississippi Mermaid,33216,0,33216,3668,1
I Kissed a Vampire,1794,0,1794,1380,11
The Woman with the 5 Elephants,11026,0,11026,4988,1
Le combat dans l'île,50039,0,50039,10217,1
Guy and Madeline on a Park Bench,35556,0,35556,3233,1
Dystopia: 2013,1708,0,1708,1011,1
Higher Ground,841733,1637,843370,21495,3
Where Are You Taking Me?,1492,0,1492,937,1
Bestiaire,1428,0,1428,0,0
Headshot,1373,114138,115511,456,1
Snowman's Land,1190,0,1190,656,1
Jack & Diane,1142,0,1142,294,2
Jason Becker: Not Dead Yet,1294,2786,4080,319,2
Monsieur Verdoux,64636,0,64636,0,0
American: The Bill Hicks Story,92234,0,92234,5872,1
My Joy,6298,50559,56857,2077,1
The Decoy Bride,759,116995,117754,542,1
Small Change,38296,0,38296,4624,1
The Loving Story,700,0,700,448,1
A Grin Without A Cat,43616,0,43616,8449,1
Battleship Potemkin,51198,6422,57620,5641,1
Metropolis,27362,113545,140907,0,0
Nature Calls,646,0,646,382,2
Citizen Gangster,625,0,625,625,1
Death of a Superhero,607,40968,41575,345,1
Gottfried Helnwein and the Dreaming Child,601,0,601,402,1
Abandoned,832,0,832,407,1
To Die Is Hard,5129,0,5129,112,1
Meeting Evil,525,0,525,181,1
Apartment 143,383,4126361,4126744,256,1
Redneck Carnage,706,0,706,20000,0
Playback,264,57323,57587,252,1
The Ghastly Love of Johnny X,2436,0,2436,86,1
Metal Messiah,3476,0,3476,0,0
Iron Man 3,409013994,805797258,1214811252,174144585,4253
The Hunger Games: Catching Fire,424668047,440343699,865011746,158074286,4163
Despicable Me 2,368065385,602700620,970766005,83517315,3997
Man of Steel,291045518,377000000,668045518,116619362,4207
Monsters University,268492764,475066843,743559607,82429469,4004
Frozen,400738009,880064273,1280802282,243390,1
Gravity,274092705,449100000,723192705,55785112,3575
Fast & Furious 6,238679850,550000000,788679850,97375245,3658
Oz The Great and Powerful,234911825,258400000,493311825,79110453,3912
Star Trek Into Darkness,228778661,238586585,467365246,70165559,3868
Thor: The Dark World,206362140,438421000,644783140,85737841,3841
World War Z,202359711,337648165,540007876,66411834,3607
The Hobbit: The Desolation of Smaug,258366855,700000000,958366855,73645197,3903
The Croods,187168425,400036243,587204668,43639736,4046
The Heat,159582188,70348583,229930771,39115043,3181
We're the Millers,150394119,119600000,269994119,26419396,3260
The Great Gatsby,144840419,208801476,353641895,50085185,3535
The Conjuring,137400141,182094497,319494638,41855326,2903
Identity Thief,134506920,39458090,173965010,34551025,3141
Grown Ups 2,133668525,113315753,246984278,41508572,3491
The Wolverine,132556852,282271394,414828246,53113752,3924
G.I. Joe: Retaliation,122523060,253217645,375740705,40501814,3719
Now You See Me,117723989,234000000,351723989,29350389,2925
Cloudy With a Chance of Meatballs 2,119793567,154532382,274325949,34017930,4001
Lee Daniels' The Butler,116632095,60681700,177313795,24637312,2933
The Hangover Part III,112200072,249800000,362000072,41671198,3555
Epic,107518682,160907952,268426634,33531068,3882
Captain Phillips,107100855,111690956,218791811,25718314,3020
Silver Linings Playbook,132092958,104319495,236412453,443003,16
Pacific Rim,101802906,309200000,411002906,37285325,3275
This Is the End,101470202,24571120,126041322,20719162,3055
Jackass Presents: Bad Grandpa,102003019,49823528,151826547,32055177,3336
Olympus Has Fallen,98925640,71344561,170270201,30373794,3098
42,95020213,2450488,97470701,27487144,3003
Zero Dark Thirty,95720716,37100000,132820716,417150,5
Django Unchained,162805434,262562804,425368238,30122888,3010
Elysium,93050117,193090583,286140700,29807393,3284
Anchorman 2: The Legend Continues,125168368,46296308,171464676,26232425,3507
Planes,90288712,148970000,239258712,22232291,3702
The Lone Ranger,89302115,171200000,260502115,29210849,3904
Oblivion,89107235,197061337,286168572,37054485,3783
Insidious: Chapter 2,83586447,78332871,161919318,40272103,3049
Turbo,83028128,199542554,282570682,21312625,3806
Les Misérables,148809770,293000000,441809770,27281735,2814
2 Guns,75612460,56327951,131940411,27059130,3025
The Hobbit: An Unexpected Journey,303003568,714000000,1017003568,84617303,4045
White House Down,73103784,132262953,205366737,24852258,3222
Mama,71628180,74800000,146428180,28402310,2647
Safe Haven,71349120,26245020,97594140,21401594,3223
The Smurfs 2,71017784,276527576,347545360,17548389,3866
The Best Man Holiday,70525195,2310515,72835710,30107555,2024
Percy Jackson: Sea of Monsters,68559554,131290761,199850315,14401054,3031
American Hustle,150117807,101054000,251171807,740455,6
A Good Day to Die Hard,67349198,237304984,304654182,24834845,3553
Warm Bodies,66380662,50600000,116980662,20353967,3009
Jack the Giant Slayer,65187603,132500000,197687603,27202226,3525
The Purge,64473115,24855512,89328627,34058360,2536
Last Vegas,63914167,70488283,134402450,16334566,3065
Ender's Game,61737191,63806833,125544024,27017351,3407
Prisoners,61002302,61124385,122126687,20817053,3260
After Earth,60522097,183089885,243611982,27520040,3401
Escape from Planet Earth,57012977,17584666,74597643,15891055,3288
Hansel & Gretel: Witch Hunters,55703475,170646274,226349749,19690956,3372
Free Birds,55750480,54636592,110387072,15805237,3736
Evil Dead,54239856,43303096,97542952,25775847,3025
RED 2,53262560,94813005,148075565,18048422,3016
Temptation: Confessions of a Marriage Counselor,51975354,1167790,53143144,21641679,2047
The Call,51872378,16700253,68572631,17118745,2507
Pain & Gain,49875291,37430258,87305549,20244505,3277
Lincoln,182207973,93085477,275293450,944308,11
Gangster Squad,46000903,59200000,105200903,17070347,3103
Jurassic Park,45385935,72806380,118192315,18620145,2771
Tyler Perry's A Madea Christmas,52543354,853281,53396635,16007634,2194
The Internship,44672764,48820080,93492844,17325307,3366
Instructions Not Included,44467206,56019410,100486616,7846426,348
Saving Mr. Banks,83301580,34566404,117867984,413373,15
Parental Guidance,77267296,42504936,119772232,14554053,3367
Snitch,42930462,14894212,57824674,13167607,2511
Riddick,42025135,56312160,98337295,19030375,3107
The Wolf of Wall Street,116900694,275100000,392000694,18361578,2537
A Haunted House,40041683,20117901,60159584,18101682,2160
Life of Pi,124987023,484029542,609016565,22451514,2927
12 Years a Slave,56671993,131061209,187733202,923715,19
The Family,36918811,41500000,78418811,14034764,3091
Carrie,35266619,49524059,84790678,16101552,3157
Texas Chainsaw,34341945,12998641,47340586,21744470,2654
R.I.P.D.,33618855,44705365,78324220,12691415,2852
Blue Jasmine,33405481,65699323,99104804,612064,6
Jack Reacher,80070736,138269859,218340595,15210156,3352
Kevin Hart: Let Me Explain,32244051,74000,32318051,10030463,876
Side Effects,32172757,31241378,63414135,9303145,2605
Scary Movie V,32015787,46362957,78378744,14157367,3402
The Secret Life of Walter Mitty,58236838,129896484,188133322,12765508,2909
The Mortal Instruments: City of Bones,31165421,64231152,95396573,9336957,3118
Delivery Man,30664106,22456240,53120346,7944977,3036
One Direction: This Is Us,28873374,39659524,68532898,15815497,2735
Kick-Ass 2,28795985,32000000,60795985,13332955,2940
This Is 40,67544505,20670651,88215156,11579175,2912
Argo,136025503,96300000,232325503,19458109,3232
Rush,26947624,68276971,95224595,187289,5
The Host,26627201,36738658,63365859,10600112,3202
The World's End,26004851,20084436,46089287,8811790,1551
21 & Over,25682380,22383292,48065672,8754168,2771
Escape Plan,25135965,112192336,137328301,9885732,2883
Don Jon,24477704,14961651,39439355,8677009,2422
Walking with Dinosaurs 3D,36076121,90470397,126546518,7091938,3231
47 Ronin,38362475,113421364,151783839,9910310,2689
The Incredible Burt Wonderstone,22537881,4900000,27437881,10177257,3160
The Big Wedding,21819348,24702789,46522137,7591663,2633
Mud,21590086,11023087,32613173,2215891,363
Baggage Claim,21569509,1301587,22871096,9031102,2027
"The Way, Way Back",21506546,4968374,26474920,552788,19
The Place Beyond the Pines,21403519,25649380,47052899,279457,4
Homefront,20158898,28290518,48449416,6915241,2570
Broken City,19701164,15036035,34737199,8268908,2620
Beautiful Creatures,19452138,40600000,60052138,7582595,2950
Runner Runner,19316646,43358449,62675095,7706712,3026
You're Next,18494006,8401475,26895481,7020196,2437
The Impossible,19019882,179067330,198087212,143818,15
Quartet,18390117,41130181,59520298,47122,2
The Book Thief,21488481,55097835,76586316,105005,4
Admission,18007317,629884,18637201,6154984,2160
Parker,17616641,29305925,46922566,7008222,2224
Enough Said,17550872,7738000,25288872,232800,4
Dark Skies,17418667,10439436,27858103,8189166,2313
Philomena,37709979,62419893,100129872,128435,4
The Counselor,16973715,54035619,71009334,7842930,3044
Grudge Match,29807260,15100000,44907260,7021993,2838
Jobs,16131410,25996942,42128352,6713900,2381
Fruitvale Station,16101339,1284491,17385830,386291,7
Dallas Buyers Club,27298285,28438303,55736588,260865,9
About Time,15322921,71777528,87100449,1076250,175
The Last Exorcism 2,15179302,9872563,25051865,7728354,2700
The Guilt Trip,37134215,4729511,41863726,5290629,2431
Spring Breakers,14124284,17600000,31724284,263002,3
"Monsters, Inc.",34043006,16164814,50207820,4774686,2618
Skyfall,304360277,804200736,1108561013,88364714,3505
Wreck-It Ralph,189422889,281800000,471222889,49038712,3752
Rise of the Guardians,103412758,203528912,306941670,23773465,3653
The Last Stand,12050299,36280458,48330757,6281433,2913
Out of the Furnace,11330849,4329819,15660668,5220288,2101
Dead Man Down,10895295,7179244,18074539,5345250,2188
Getaway,10501938,1304494,11806432,4503892,2130
Bullet to the Head,9489829,12457380,21947209,4548201,2404
Peeples,9177065,130101,9307166,4611534,2041
Battle of the Year,8888355,7661122,16549477,4603177,2008
Movie 43,8840453,23598535,32438988,4805878,2023
Before Midnight,8114627,12880021,20994648,246914,5
Machete Kills,8008161,9488659,17496820,3837183,2538
Paranoia,7388654,8111990,15500644,3528376,2459
Promised Land,7597898,3441133,11039031,173915,25
Dhoom 3,8031955,80000000,88031955,3423508,239
Black Nativity,7018189,435996,7454185,3669530,1516
The Spectacular Now,6854611,63980,6918591,197415,4
The Grandmaster,6594959,57481777,64076736,132617,7
Amour,6739492,22912688,29652180,68266,3
Hubble 3D,52522904,21726825,74249729,413477,39
Nebraska,17654912,10027960,27682872,140401,4
All Is Lost,6263670,7363849,13627519,93583,6
The Twilight Saga: Breaking Dawn - Part 2,292324737,537422083,829746820,141067634,4070
The Bling Ring,5845732,14199844,20045576,214395,5
Pulling Strings,5842961,7882858,13725819,2467168,387
Closed Circuit,5750401,581538,6331939,2464931,870
The Wizard of Oz,5633202,154600,5787802,3093998,318
Chennai Express,5307960,4926693,10234653,2220497,196
Mandela: Long Walk to Freedom,8323085,19662703,27985788,84283,4
Inside Llewyn Davis,13235319,19700000,32935319,405411,4
The Company You Keep,5133027,14881653,20014680,131718,5
Justin Bieber's Believe,6206566,4773591,10980157,2007567,1037
20 Feet from Stardom,4946445,892923,5839368,54596,3
Hyde Park on Hudson,6376145,4604336,10980481,81362,4
Cirque du Soleil: Worlds Away,12512862,21640239,34153101,2162993,840
Much Ado About Nothing,4328849,1012372,5341221,171942,5
Frances Ha,4069826,4943335,9013161,137398,4
Yeh Jawaani Hai Deewani,3827466,2362532,6189998,1568677,161
The To Do List,3491669,417927,3909596,1579402,591
Metallica Through the Never,3419967,4555845,7975812,1576561,305
Emperor,3346265,11511975,14858240,1014099,260
Stand Up Guys,3310031,1762623,5072654,1486390,659
The Fifth Estate,3255008,5803556,9058564,1673351,1769
Love Is All You Need,1631709,15090434,16722143,36746,4
Top Gun,3018873,0,3018873,1965737,300
In a World...,2963902,151051,3114953,70541,3
To the Arctic 3D,14560838,9134550,23695388,270228,50
Home Run,2861020,0,2861020,1623000,381
Filly Brown,2850357,90054,2940411,1478323,188
Hotel Transylvania,148313048,210062555,358375603,42522194,3349
RamLeela,2738863,2101196,4840059,1449174,204
Space Station 3D,93383953,34979928,128363881,489488,24
Grace Unplugged,2507201,0,2507201,998145,511
The Sapphires,2450867,17972761,20423628,38372,4
The Gatekeepers,2415727,157889,2573616,61552,3
I'm in Love with a Church Girl,2387730,115662,2503392,971826,457
No,2343664,5355431,7699095,71742,4
Trance,2328743,21932826,24261569,131145,4
The East,2301839,589973,2891812,77031,4
Renoir,2293798,5522775,7816573,65194,6
The Christmas Candle,2258620,218155,2476775,68655,5
Krrish 3,2191534,1978670,4170204,1049560,208
Oldboy,2193658,2993109,5186767,885382,583
Austenland,2159041,154468,2313509,40662,4
The Oscar Nominated Short Films 2013: Live Action,2142342,0,2142342,371605,105
Blackfish,2073582,229835,2303417,75962,5
Blue Is the Warmest Colour,2199787,17266048,19465835,100316,4
Anna Karenina,12816367,56112783,68929150,320690,16
The Iceman,1969193,2583777,4552970,87946,4
Her,25568251,22949176,48517427,260382,6
Flight,93772375,68000000,161772375,24900566,1884
Fill the Void,1775316,1422299,3197615,59164,3
Born to Be Wild,25978556,15665919,41644475,871478,206
The Attack,1720325,419191,2139516,27379,3
Stoker,1714221,10363220,12077441,160547,7
Unfinished Song,1702668,7464197,9166865,25728,2
Bhaag Milkha Bhaag,1636731,689186,2325917,647112,140
Girl Rising,1727259,0,1727259,81640,34
Stories We Tell,1600145,1040908,2641053,27053,2
Race 2,1579940,1584501,3164441,884757,153
Here Comes the Boom,45290318,27809854,73100172,11816596,3014
Beasts of the Southern Wild,12795746,8312000,21107746,169702,4
The Saratov Approach,2146999,0,2146999,137226,23
Flying Monsters 3D with David Attenborough,5705874,5107988,10813862,0,0
Kon-Tiki,1517410,21325477,22842887,22168,2
Jerusalem,8020721,1258735,9279456,0,0
Disconnect,1436900,1991148,3428048,124000,15
Rust and Bone,2062027,23745685,25807712,27154,2
Girl Most Likely,1378591,707026,2085617,694447,351
I'm So Excited!,1368119,19877558,21245677,97328,5
Red Dawn,44806783,6143513,50950296,14276668,2724
The Ultimate Life,1327841,0,1327841,659912,412
Wadjda,1347747,5151422,6499169,41253,3
The Kings of Summer,1315590,186005,1501595,58962,4
Under the Sea 3D,36262926,19639698,55902624,661185,49
Inequality for All,1205273,0,1205273,140888,28
The Lords of Salem,1165882,379107,1544989,642942,354
Romeo and Juliet,1162635,1803633,2966268,520116,461
Kai Po Che,1122527,312745,1435272,522765,110
"Bless Me, Ultima",1561962,0,1561962,470109,263
What Maisie Knew,1066471,1644908,2711379,21480,1
Thanks for Sharing,1065881,2433561,3499442,536591,269
Phantom,1034589,163170,1197759,508000,1118
Ginger & Rosa,1012973,661803,1674776,42838,3
Short Term 12,1013100,632064,1645164,56206,4
From Up on Poppy Hill,1002895,60456530,61459425,57585,2
Lore,970325,1391694,2362019,31498,6
Kill Your Darlings,1030064,847860,1877924,53452,4
A Royal Affair,1546761,13212236,14758997,38212,7
Taken 2,139854287,236287019,376141306,49514769,3661
Hitchcock,6008677,21030992,27039669,287715,17
Raanjhanaa,903232,268529,1171761,414211,102
Generation Iron,849521,52128,901649,245000,53
Deep Sea,46412757,51818148,98230905,700213,43
Barbara,1013902,5875283,6889185,63410,15
The Great Beauty,2852400,21419339,24271739,23442,1
Only God Forgives,779188,9855938,10635126,313958,78
Burn,996103,0,996103,0,0
The Revolution Has Begun,738525,484894,1223419,412148,83
Still Mine,1159336,393394,1552730,0,0
Hannah Arendt,717205,8163731,8880936,31270,1
56 Up,701278,0,701278,22088,1
Searching for Sugar Man,3696196,5426210,9122406,27459,3
Shameless,679866,763613,1443479,364962,217
Muscle Shoals,696241,13174,709415,13901,1
Parkland,653651,758530,1412181,310246,257
On the Road,744296,8873081,9617377,39550,4
The Hunt,613308,15229966,15843274,43045,4
To the Wonder,587615,2213551,2801166,116551,17
Salinger,583633,67042,650675,86956,4
Lootera,581813,207858,789671,314958,100
Frankenweenie,35291068,46200000,81491068,11412213,3005
Pitch Perfect,65001093,50349333,115350426,5149433,335
Museum Hours,561457,77664,639121,29400,2
The Lost Medallion: The Adventures of Billy Stone,549632,156222,705854,143532,68
Chasing Ice,1328467,30201,1358668,0,0
The Reluctant Fundamentalist,552959,1614061,2167020,30920,3
Scatter My Ashes at Bergdorf's,518342,0,518342,39630,4
The Face Reader,515876,61043308,61559184,159720,19
Not Fade Away,610792,25607,636399,19182,3
The Inevitable Defeat of Mister & Pete,494608,11695,506303,254279,147
The Sessions,6002451,4653704,10656155,113467,4
The Act of Killing,486919,235795,722714,27450,1
New World,457806,31212801,31670607,129954,24
Upstream Color,444098,143076,587174,28649,1
Sound City,422853,98328,521181,62842,16
The Master,16377274,11880786,28258060,736311,5
The Perks of Being a Wallflower,17742948,15641179,33384127,228359,4
A Hijacking,414437,2274007,2688444,39392,7
Grand Masti,413903,356632,770535,223222,64
The Torn Poster Let Out a Hero,410526,258544,669070,260188,94
Ain't Them Bodies Saints,396519,634724,1031243,26419,3
In the House,389757,15801014,16190771,31441,3
Playing for Keeps,13103272,17859063,30962335,5750288,2837
Dirty Wars,384473,32380,416853,63504,4
At Any Price,380594,106861,487455,16095,4
Puella Magi Madoka Magica the Movie Part III: The Rebellion Story,375627,19169007,19544634,189514,37
Hava Nagila,370218,0,370218,8218,1
Shootout at Wadala,369573,341793,711366,212346,89
Lovelace,356582,1229001,1585583,184536,118
Fearless 2,2519190,1697798,4216988,1019213,166
The Angels' Share,346669,12743802,13090471,18837,3
Drinking Buddies,343341,58573,401914,19505,2
Koch,342941,0,342941,35196,2
Gori Tere Pyaar Mein!,342184,366256,708440,199463,112
Starbuck,340058,2525010,2865068,15530,3
Happy People: A Year in the Taiga,338987,0,338987,10481,1
Diana,335359,21430912,21766271,67754,38
The Armstrong Lie,383294,211100,594394,28992,5
Camp,324977,0,324977,7785,1
Cloud Atlas,27108272,103374596,130482868,9612247,2008
Adore,318982,1256767,1575749,119806,57
Not Today,318121,0,318121,96347,41
Linsanity,302645,30345,332990,99462,9
Go Goa Gone,298457,130893,429350,170044,92
Room 237,296359,71047,367406,29693,2
West of Memphis,310154,8163,318317,13360,5
You Will Be My Son,285151,40910,326061,15301,1
Personal Tailor,375892,115750566,116126458,112224,9
A Late Quartet,1562548,4741161,6303709,75279,9
Blancanieves,279735,2305787,2585522,25264,4
Himmatwala,270880,425454,696334,197770,99
Meerkats,777595,482021,1259616,0,0
Great Expectations,258656,5944223,6202879,88500,86
August: Osage County,37738810,36450127,74188937,179302,5
The Attacks of 26/11,248346,0,248346,159619,51
The Summit,243550,34101,277651,20904,8
Like Someone in Love,239056,323822,562878,21813,3
End of Watch,41003371,14074775,55078146,13152683,2730
When Comedy Went to School,369065,0,369065,17001,5
A Place at the Table,231378,0,231378,92257,35
InAPPropriate Comedy,228004,0,228004,156414,275
Singh Saab the Great,225668,162954,388622,138127,54
ABCD (Any Body Can Dance),222098,18096,240194,95236,25
Haute Cuisine,217883,11292059,11509942,14387,3
Arthur Newman,207853,539287,747140,112788,248
Prince Avalanche,205139,237174,442313,36694,14
Ghanchakkar,203044,261759,464803,143616,89
Crystal Fairy & the Magical Cactus,202370,21451,223821,25052,2
No Place on Earth,200238,0,200238,13813,2
Free Angela and All Political Prisoners,194102,903,195005,69306,16
Midnight's Children,190022,1053958,1243980,12200,2
Killing Them Softly,15026056,22904409,37930465,6812900,2424
Lone Survivor,125095601,29707311,154802912,90872,2
The Anonymous People,284147,0,284147,0,0
Ice Age: Continental Drift,161321843,715922939,877244782,46629259,3881
Populaire,179091,12519294,12698385,15690,3
A.C.O.D.,175705,0,175705,19001,3
Afternoon Delight,174496,1259,175755,27352,2
SOMM,174197,0,174197,28050,5
"Cinco de Mayo, La Batalla",173472,2621380,2794852,83586,20
Escape from Tomorrow,171962,0,171962,63297,30
Copperhead,171740,0,171740,55625,59
Cutie and the Boxer,200036,0,200036,21098,3
R... Rajkumar,166503,243992,410495,124669,91
We Steal Secrets,166243,291274,457517,27689,4
On the Job,164620,308270,472890,56098,29
Mother of George,157937,0,157937,22500,1
LUV,156996,0,156996,83194,45
Deceptive Practice: The Mysteries and Mentors of Ricky Jay,152791,0,152791,13802,1
Snake & Mongoose,152200,0,152200,20254,1
The Patience Stone,148671,505916,654587,9361,2
Rangeelay,148418,94828,243246,73541,20
Free the Mind,157201,11715,168916,12215,1
Narco Cultura,145088,18602,163690,6093,1
John Dies at the End,141951,0,141951,12467,1
Galapagos,18630372,10718800,29349172,0,0
Good Ol' Freda,138811,0,138811,6798,1
American Promise,146702,0,146702,18300,2
Fists of Legend,134213,11344668,11478881,49252,23
Alone Yet Not Alone,887851,0,887851,125775,11
Drug War,128195,24548146,24676341,5926,1
The Artist and the Model,127958,1364822,1492780,16900,2
A Band Called Death,127257,0,127257,34839,15
Holy Motors,641100,1313025,1954125,18866,2
Europa Report,125687,0,125687,22243,3
Fukrey,125279,55052,180331,74110,57
Is the Man Who Is Tall Happy?,137042,0,137042,31800,3
Beyond the Hills,124919,548574,673493,14622,3
Lost and Found in Armenia,122305,110552,232857,49829,9
The Other Son,1285918,2534487,3820405,125691,41
Spark: A Burning Man Story,120459,0,120459,9366,2
Storm Surfers 3D,117090,472855,589945,7299,2
Yossi,117047,11621,128668,12287,2
Ain't in It for My Health: A Film About Levon Helm,113966,0,113966,7937,1
Spinning Plates,112449,12407,124856,20717,3
Ek Thi Daayan,112135,94144,206279,65857,47
The Punk Singer,122742,23258,146000,24729,3
Augustine,107352,155038,262390,13616,5
Big Star: Nothing Can Hurt Me,105998,0,105998,15096,2
Upside Down,105095,22082718,22187813,28722,11
The English Teacher,104810,215203,320013,6001,2
Gimme the Loot,104442,12341,116783,21065,1
A Touch of Sin,154120,700771,854891,19867,2
The Investigator,103739,0,103739,93690,11
Stevie Nicks: In Your Dreams,103028,0,103028,0,0
Thérèse,101944,4306143,4408087,20050,6
Computer Chess,102041,25811,127852,9683,2
Capital,101700,4721149,4822849,22400,2
The Past,1331747,11341715,12673462,29270,3
Una noche,100887,11016,111903,17194,3
Shadow Dancer,100616,2153203,2253819,10672,2
The United States of Autism,100403,0,100403,3413,1
One Track Heart: The Story of Krishna Das,100401,0,100401,11515,1
The Broken Circle Breakdown,175058,5815696,5990754,7100,1
Das letzte Schweigen,100214,184257,284471,7992,2
Man of Tai Chi,100144,5364741,5464885,61054,110
Blue Caprice,93995,0,93995,13400,1
Passion,92181,621435,713616,33400,14
Any Day Now,201395,60352,261747,40489,16
King's Faith,90106,0,90106,27648,6
Somebody Up There Likes Me,89435,0,89435,34362,1
Byzantium,89237,739047,828284,16643,6
Finding Nemo,41128283,50716243,91844526,16687773,2904
Settai,87838,334409,422247,52386,33
Young Detective Dee: Rise of the Sea Dragon,87783,98687108,98774891,32795,35
The Rooftop,85755,19747397,19833152,47259,17
Something in the Air,85154,1220319,1305473,13288,3
We Are What We Are,81381,77666,159047,13727,2
Stuck in Love.,81071,896600,977671,34967,21
Winnie Mandela,80634,0,80634,61847,32
Ramaiya Vastavaiya,80108,0,80108,52514,67
The Central Park Five,325653,0,325653,30570,3
Money for Nothing: Inside the Federal Reserve,88045,0,88045,0,0
Caesar Must Die,76908,1490431,1567339,0,0
Commitment,76543,6758259,6834802,0,0
Leviathan,76202,20576,96778,10000,1
More Than Honey,79772,1524837,1604609,5225,1
No One Lives,74918,973786,1048704,47800,53
Bettie Page Reveals All,108118,0,108118,4846,1
Reality,72577,3278419,3350996,7072,1
After Tiller,72125,0,72125,15500,2
An Oversimplification of Her Beauty,71906,0,71906,10055,2
Seasons of Gray,70605,0,70605,31953,24
War Witch,70544,242843,313387,8714,2
The Waiting Room,244951,0,244951,7086,4
The Invisible Woman,1234254,2752634,3986888,31948,3
Pandora's Promise,66680,0,66680,23419,16
Fei chang xing yun,64432,22194747,22259179,47006,23
Diana Vreeland: The Eye Has to Travel,1017579,703893,1721472,63700,3
Beware of Mr. Baker,116476,93647,210123,12195,1
Becoming Traviata,62652,39363,102015,5000,1
Sightseers,61782,2061127,2122909,7384,2
Go for Sisters,70495,0,70495,6001,2
I Am Divine,81497,34242,115739,0,0
Let the Fire Burn,64489,0,64489,5226,1
Independent Lens: Don't Stop Believin': Everyman's Journey,61018,0,61018,25573,23
Journey to the South Pacific,7653913,7340963,14994876,8137,1
It's a Disaster,60818,0,60818,15305,3
How I Live Now,60213,865549,925762,28547,68
The Wicker Man,60891,0,60891,5493,1
The Pervert's Guide to Ideology,67966,146347,214313,9165,1
Aftershock,58510,236186,294696,40179,110
The Trials of Muhammad Ali,59081,0,59081,2980,1
Chasing Mavericks,6002756,1939360,7942116,2268274,2002
Lost in Thailand,57387,197700000,197757387,32206,29
The Canyons,56825,213360,270185,13351,1
Sister,154659,1063515,1218174,15401,3
Terms and Conditions May Apply,55824,0,55824,4446,1
Bajatey Raho,55397,13688,69085,37801,44
C.O.G.,55301,0,55301,32677,20
Final: The Rapture,124561,0,124561,31900,2
Line of Duty,54204,0,54204,26839,15
Samsara,2672413,1754031,4426444,76222,2
Leonie,53692,0,53692,291,1
The Square,124244,0,124244,16359,1
The Intouchables,10198820,416389690,426588510,103507,4
Venus and Serena,51271,0,51271,10981,4
God Loves Uganda,51229,0,51229,7300,1
Puella Magi Madoka Magica the Movie Part 1: Beginnings,180440,5635890,5816330,62340,5
Mademoiselle C,48668,27953,76621,14284,6
A Cop,48040,0,48040,10342,1
GMO OMG,47558,0,47558,15100,1
Table No. 21,46720,30901,77621,31658,23
Jewtopia,46437,41890,88327,26371,16
Wish You Were Here,46347,29523,75870,25937,11
Wrong,46021,60404,106425,20424,16
The Lovely Month of May,55038,0,55038,10662,3
Tiny Times 2.0,43788,47246149,47289937,20652,6
Reaching for the Moon,45502,1488889,1534391,14573,2
A Glimpse Inside the Mind of Charles Swan III,45350,165215,210565,12000,2
American Made Movie,45175,0,45175,1613,2
Greedy Lying Bastards,45000,1121,46121,45000,50
My Brother the Devil,44906,87150,132056,10305,2
Andre Gregory: Before and After Dinner,42892,0,42892,7980,1
Concussion,42606,36351,78957,8313,2
Zaytoun,42330,135423,177753,4100,2
The We and the I,42172,253758,295930,10774,1
Holla II,41537,0,41537,37444,6
Bill W.,809590,0,809590,0,0
Language of a Broken Heart,40645,0,40645,5861,1
CBGB,40400,0,40400,3909,1
Escape Fire: The Fight to Rescue American Healthcare,126238,0,126238,30953,12
Killing Season,39881,1031441,1071322,27713,12
The Short Game,39819,0,39819,28434,17
Faust,58132,0,58132,10030,2
How to Make Money Selling Drugs,39192,0,39192,9202,5
Post Tenebras Lux,39185,85094,124279,4674,1
Harvest of Empire,79627,0,79627,0,0
Herb & Dorothy 50X50,38933,0,38933,6157,1
The Wall,38674,3850586,3889260,2188,1
The Odd Life of Timothy Green,51854875,4157767,56012642,10822903,2598
Berberian Sound Studio,38493,274264,312757,6605,5
Rising from Ashes,38602,15202,53804,7298,3
Russian Ark,37984,0,37984,0,0
Ip Man: The Final Fight,37884,3929117,3967001,15514,14
Mumia: Long Distance Revolutionary,37731,0,37731,9283,1
Big Sur,37466,0,37466,16835,13
Savannah,37240,0,37240,15599,14
Redemption,36895,12634214,12671109,19977,19
Going Attractions: The Definitive Story of the American Drive-in Movie,52458,0,52458,0,0
The Servant,36463,0,36463,7859,1
Touchy Feely,36128,0,36128,3447,2
Far Out Isn't Far Enough: The Tomi Ungerer Story,35647,0,35647,3700,1
M,35566,0,35566,6123,1
Underdogs,35271,0,35271,18722,4
Tai Chi 2: The Hero Rises,35067,633417,668484,12624,7
The Girl,35048,0,35048,11164,2
I Give It a Year,34657,28293874,28328531,5436,2
5 Broken Cameras,109983,36492,146475,6674,1
Paranormal Activity 4,53885000,88917657,142802657,29003866,3412
Contempt,43763,0,43763,8322,1
Bert Stern: Original Madman,34005,0,34005,4691,4
Running from Crazy,33300,0,33300,6822,1
Dislecksia: The Movie,33066,0,33066,2213,1
Maniac,31081,2600194,2631275,5571,1
Somewhere Between,210975,0,210975,7799,1
These Birds Walk,30408,0,30408,5454,1
The House I Live In,210752,8407,219159,16453,2
Gregory Crewdson: Brief Encounters,60064,0,60064,1492,1
Long Shot: The Kevin Laue Story,29863,0,29863,7006,1
A Fierce Green Fire: The Battle for A Living Planet,29817,0,29817,0,0
Dead Man's Burden,29634,0,29634,7620,1
Robot & Frank,3325038,1481385,4806423,35539,2
Struck by Lightning,28378,0,28378,12940,1
Camille Claudel 1915,35296,625059,660355,5106,1
Simon Killer,27740,0,27740,5054,1
Bad Blood,35176,8582,43758,8482,1
Broadway Idiot,27595,0,27595,5514,1
Tiger Eyes,27160,0,27160,10874,17
Out in the Dark,26966,39051,66017,14067,6
The Sweeney,26650,7681662,7708312,20321,11
At Berkeley,31736,0,31736,5069,2
Little Fugitive,29505,0,29505,9040,1
Sinister,48086903,34428210,82515113,18007634,2527
Sweet Dreams,59403,0,59403,0,0
The Power of Few,25000,0,25000,7614,2
Graceland,24529,0,24529,13059,15
Bastards,24525,415410,439935,4432,1
Le Petit Soldat,24296,0,24296,6848,1
The Citizen,24296,24471,48767,368,1
Paradise: Love,24267,1684769,1709036,6014,2
Brooklyn Castle,219407,0,219407,18761,2
Greenwich Village: Music That Defined a Generation,23701,0,23701,5530,1
Dear Mr. Watterson,23899,0,23899,6199,5
Brave,237283207,301700000,538983207,66323594,4164
Tiny Times,23462,77693552,77717014,12294,3
Our Children,23203,677012,700215,5500,1
The Last Days on Mars,24084,163107,187191,4608,3
Harry Dean Stanton: Partly Fiction,23959,0,23959,6330,2
I Used to Be Darker,22214,16760,38974,3533,1
Murder Eleven,22107,0,22107,8106,2
Pieta,22080,6594216,6616296,6222,12
V/H/S/2,21833,783741,805574,9932,12
The ABCs of Death,21832,0,21832,10110,19
Blue Exorcist: The Movie,21796,5973125,5994921,0,0
Hitler's Children,28663,0,28663,2939,1
Évocateur: The Morton Downey Jr. Movie,21652,0,21652,3936,5
Violeta Went to Heaven,21496,1444536,1466032,5588,2
Tio Papi,21316,0,21316,16108,21
The Painting,21008,1305,22313,3626,1
Viola,21818,0,21818,6109,1
The Ghosts in Our Machine,20709,0,20709,8756,1
Our Nixon,20584,0,20584,6090,3
Hunky Dory,20296,119357,139653,7443,11
Wedding Palace,19908,0,19908,19908,6
Bad Milo,19613,0,19613,4503,11
Whensday,19463,0,19463,12497,1
Smash & Grab: The Story of the Pink Panthers,18938,0,18938,4794,1
Alex Cross,25888412,8730455,34618867,11396768,2539
Fire in the Blood,28994,0,28994,4856,1
Nostalgia,18846,0,18846,5233,1
The Sorcerer and the White Snake,18759,0,18759,5530,1
A Single Shot,18642,0,18642,10020,10
Let My People Go!,18529,0,18529,2236,1
You Ain't Seen Nothin' Yet,18929,1147811,1166740,5343,2
Four Bags Full,18297,0,18297,9997,1
Twice Born,18295,9056836,9075131,14947,10
Torn,18202,0,18202,4881,1
Casting By,18164,4333,22497,5649,2
Talaash,2871956,2405810,5277766,1638706,172
Mental,17669,4429183,4446852,9804,12
The History of Future Folk,17646,0,17646,5775,1
Jamel Shabazz Street Photographer,17992,0,17992,7105,1
Cousin Jules,29337,0,29337,5135,1
Violet & Daisy,17186,90953,108139,9982,17
Le Pont du Nord,17110,0,17110,5333,1
Night Across the Street,16778,0,16778,3248,1
Love and Honor,19684,622245,641929,2815,2
Dealin' with Idiots,17909,0,17909,8508,1
As I Lay Dying,16697,55062,71759,7143,1
La Camioneta: The Journey of One American School Bus,18558,0,18558,0,0
The Rabbi's Cat,23392,4185181,4208573,4301,1
The Look of Love,21252,1297216,1318468,5105,3
Out of the Clear Blue Sky,16050,0,16050,2344,1
Detropia,390024,0,390024,17414,1
In Another Country,25079,586286,611365,3207,1
Masquerade,922921,93345511,94268432,0,0
I Declare War,14928,0,14928,8634,14
Jayne Mansfield's Car,14836,64342,79178,9320,11
Kiss of the Damned,14752,0,14752,2723,2
The Unbelievers,14400,0,14400,5925,1
A Wedding Invitation,14350,30650686,30665036,3183,2
Design Is One: The Vignellis,16386,0,16386,4236,1
Il Futuro,14001,0,14001,2583,1
The Prey,13959,779,14738,5889,5
Dorfman in Love,13737,0,13737,6410,9
The Monk,13472,1796055,1809527,8418,11
Tchoupitoulas,19375,0,19375,2379,1
Red Obsession,13199,225024,238223,5060,2
The Flat,471842,111601,583443,19916,3
A Green Story,12901,0,12901,6768,4
Breakdance Academy,12708,0,12708,0,0
Django,25916,0,25916,6150,8
Shahid,12153,0,12153,12153,16
A Werewolf Boy,342922,45939666,46282588,0,0
Neighboring Sounds,60255,404827,465082,12666,2
In the Fog,11894,174944,186838,2327,1
Charlie Countryman,11650,432340,443990,7973,15
36 Saints,11640,0,11640,7373,9
Only the Young,15312,0,15312,1446,1
My Worst Nightmare,21952,8204592,8226544,1142,1
So Young,11186,114915508,114926694,5281,3
Looper,66486205,110020614,176506819,20801552,2992
Greetings from Tim Buckley,11157,998,12155,0,0
A Resurrection,10730,0,10730,7300,17
Made in Cleveland,10681,0,10681,3411,5
American Meat,10650,0,10650,7659,1
Caucus,10645,0,10645,0,0
Midget Zombie Takeover,11006,0,11006,2755,1
Evil Intent,10454,0,10454,205,1
Shanghai Calling,10400,0,10400,10400,4
Elemental,10358,0,10358,0,0
Port of Shadows,27389,12234,39623,6618,1
Liv & Ingmar,10347,129694,140041,5451,2
Shepard & Dark,10278,0,10278,1226,1
Informant,10068,0,10068,2947,2
Arbitrage,7919574,27565482,35485056,2002165,197
In the Name Of,9883,1118055,1127938,2635,1
Orchestra of Exiles,34577,0,34577,6719,1
Inch'Allah,9840,307816,317656,3391,1
Birth of the Living Dead,9802,0,9802,1239,6
Welcome to the Punch,9747,3916639,3926386,2736,2
Antoine and Antoinette,9704,0,9704,4147,1
If I Were You,9432,0,9432,3889,14
Zero Charisma,9417,0,9417,0,0
The End of Love,9342,0,9342,1955,2
Looking for Maria Sanchez,9338,0,9338,9338,2
The Invisible War,71968,0,71968,16500,4
Better Mus' Come,9318,0,9318,6140,2
Starlet,88212,58010,146222,15662,6
Justice Is Mind,14360,0,14360,5418,1
11 Flowers,9213,2386,11599,3516,2
Ghost Team One,9195,0,9195,7345,15
Call Me Kuchu,9124,2986,12110,3476,1
Clandestine Childhood,9017,1203337,1212354,8137,2
Big Words,8965,0,8965,7371,2
White Elephant,8884,4379023,4387907,5098,1
Hell Baby,8785,0,8785,4980,10
Wagner & Me,37745,16470,54215,4891,2
The Institute,8445,0,8445,3017,2
Hello Herman,8437,0,8437,5985,15
The Happy Sad,8395,0,8395,4560,2
Downloaded,8377,0,8377,2504,2
A Teacher,8348,0,8348,4684,2
Aliyah,8253,0,8253,1627,1
La Maison de la radio,8095,6810,14905,1410,1
Pawn Shop Chronicles,8088,1992,10080,4915,15
Nothing Left to Fear,7886,1667495,1675381,7886,5
And While We Were Here,7750,0,7750,7750,19
Girls Against Boys,7529,0,7529,6111,2
Desperate Acts of Magic,7373,0,7373,2238,1
ParaNorman,56003051,51136348,107139399,14087050,3429
The Brass Teapot,6997,0,6997,4468,2
Trouble Every Day,9189,0,9189,2984,1
Assaulted: Civil Rights Under Fire,6905,0,6905,4570,17
Sal,6883,0,6883,5375,1
The Human Scale,6878,0,6878,0,0
The Selfish Giant,12189,1101838,1114027,2589,3
Breakfast with Curtis,6629,0,6629,1601,1
Brief Reunion,6601,0,6601,3085,2
Finding Mr. Right,6945,84105088,84112033,3430,3
Down the Shore,6558,0,6558,4808,2
Paradise: Faith,6508,612188,618696,2179,3
Magnificent Desolation: Walking on the Moon 3D,34137524,6201878,40339402,479587,80
100 Bloody Acres,6388,0,6388,3419,13
Inescapable,6334,0,6334,1545,2
Northern Lights,9453,0,9453,2256,1
Some Velvet Morning,6420,0,6420,0,0
Max and the Junkmen,35387,0,35387,11264,1
Guitar Innovators: John Fahey & Nels Cline,6132,0,6132,1119,1
Welcome to Pine Hill,6115,0,6115,3629,1
Rangrezz,6108,0,6108,4318,11
Nothing But a Man,13063,0,13063,3466,1
The Playroom,5964,0,5964,3900,12
The Worst Movie Ever!,25206,0,25206,11,1
Maidentrip,68243,0,68243,1622,1
A Bottle in the Gaza Sea,5872,660139,666011,2531,1
Five Dances,5788,0,5788,5788,1
A Dark Truth,5750,0,5750,630,1
Knife Fight,5661,0,5661,0,0
The Last Time I Saw Macao,6095,0,6095,2838,1
The Guillotines,5290,12212150,12217440,3296,10
The Time Being,5274,0,5274,0,0
Paradise: Hope,6701,450431,457132,2664,1
Bidder 70,5074,0,5074,2477,1
Far from Vietnam,8132,0,8132,1125,1
Futaba kara tooku hanarete,4960,0,4960,2268,1
Herman's House,4956,0,4956,3552,1
The Man Who Shook the Hand of Vicente Fernandez,10782,0,10782,3099,1
Supporting Characters,4917,0,4917,0,0
Revelation Road 2: The Sea of Glass and Fire,4871,0,4871,3722,5
Deadfall,66351,1879903,1946254,19391,11
Hôtel Normandy,4640,832069,836709,2552,1
Dracula 3D,8139,635619,643758,3085,6
All Is Bright,4556,0,4556,4556,10
All Together,43180,8792723,8835903,12887,10
People of a Feather,5677,0,5677,2413,1
Ferlinghetti: A Rebirth of Wonder,4816,0,4816,1197,1
The Iran Job,23115,0,23115,4295,1
North Sea Texas,28307,0,28307,4487,3
Radio Unnameable,24090,0,24090,5833,1
When the Iron Bird Flies: Tibetan Buddhism Arrives in the West,13598,0,13598,0,0
3 Geezers!,4175,0,4175,1372,15
The Revisionaries,22664,0,22664,2608,1
Pawn,4141,0,4141,2137,1
Contracted,4105,0,4105,3328,3
Weekend of a Champion,4100,876,4976,4100,2
Silver Circle,4080,0,4080,1314,1
The Kitchen,4054,0,4054,0,0
Morning,4029,0,4029,2876,4
Approved for Adoption,4015,0,4015,4015,1
Entre les Bras,47439,0,47439,5643,2
Three Worlds,3952,319796,323748,1791,1
The Well Digger's Daughter,386368,12807799,13194167,10273,3
What's in a Name?,8111,31295469,31303580,0,0
Back to 1942,312954,605533,918487,105702,20
"High Tech, Low Life",3836,0,3836,1718,1
The Condemned,3718,0,3718,2511,1
Mr. Nobody,3622,0,3622,1612,4
Tricked,3533,0,3533,1930,1
The Stroller Strategy,3462,2397829,2401291,1799,1
The Happy Poet,3400,0,3400,1847,1
Swerve,3338,0,3338,2725,5
Axe Giant: The Wrath of Paul Bunyan,3287,0,3287,775,2
Plush,3080,25784,28864,2843,10
Drew: The Man Behind the Poster,3078,0,3078,1764,1
A Girl and a Gun,3018,0,3018,1731,9
Approaching Midnight,2795,0,2795,1119,6
Le Amiche,68167,0,68167,10092,1
The End of Time,4375,0,4375,1468,1
What Richard Did,2749,485578,488327,0,0
Here Comes the Devil,4534,0,4534,783,2
Come Out and Play,2638,269097,271735,1600,10
Sparrows Dance,2602,0,2602,0,0
Last Flight of the Champion,2597,0,2597,1493,15
Cassadaga,2544,0,2544,1678,3
Almost in Love,2510,0,2510,1110,1
The Last Day of August,2492,0,2492,1693,1
Men at Lunch,2483,0,2483,1530,1
California Solo,15433,0,15433,3412,1
The Law in These Parts,13683,0,13683,2814,1
Lotus Eaters,2325,0,2325,1715,1
The Ghastly Love of Johnny X,2436,0,2436,86,1
The Happy House,2311,0,2311,1756,1
InSpectres,2207,0,2207,610,1
Smashed,376597,123128,499725,26943,4
Red Flag,2075,0,2075,2075,1
Rubberneck,2075,0,2075,2075,1
The Polar Express,669289,0,669289,73514,15
Best Man Down,1938,0,1938,1171,2
Detention of the Dead,1777,0,1777,1332,2
You Don't Need Feet to Dance,1719,0,1719,1239,1
Eddie: The Sleepwalking Cannibal,1632,43972,45604,1016,5
"Now, Forager",11146,0,11146,1539,1
The Fitzgerald Family Christmas,50292,0,50292,13800,4
The Package,1469,0,1469,1095,1
Officer Down,1463,253617,255080,1061,1
This Is Not a Film,77016,11742,88758,12608,5
Small Change,38296,0,38296,4624,1
A Man Vanishes,6201,0,6201,1576,2
The Man in the White Suit,8718,0,8718,3874,1
We Won't Grow Old Together,14104,0,14104,1677,1
Meet the Fokkens,30810,0,30810,7628,1
The Bride Wore Black,44566,0,44566,6463,1
"The Devil, Probably",26816,0,26816,1688,1
Sushi: The Global Catch,5757,0,5757,516,1
Monsieur Verdoux,64636,0,64636,0,0
A Zombie Invasion,1170,0,1170,0,0
Summer,43839,0,43839,4957,1
Veer!,1132,0,1132,713,1
Caught in the Web,1067,13966,15033,361,1
Khumba,1029,27186346,27187375,1029,2
Remnants,1022,0,1022,0,0
Terkel in Trouble,40385,0,40385,3972,2
Putin's Kiss,10082,0,10082,1525,1
Billy and Buddy,894,17399159,17400053,0,0
I Spit on Your Grave 2,809,677795,678604,441,1
Breathing,4630,802806,807436,949,1
Kumaré,132160,0,132160,9601,1
Into the White,704,75043,75747,90,1
Syrup,663,0,663,301,1
Alps,16057,127177,143234,2628,2
Hammer of the Gods,641,1949,2590,164,2
The Day He Arrives,13746,308602,322348,3311,1
Le combat dans l'île,50039,0,50039,10217,1
Triumph of the Wall,476,0,476,430,1
A Perfect Man,7117,7030,14147,388,2
The Long Day Closes,22765,0,22765,1407,1
Citadel,13377,128509,141886,5715,1
Planet of Snail,13957,2045,16002,2011,1
The Turin Horse,56391,105697,162088,9145,1
The Comedy,41113,0,41113,6000,1
Metal Messiah,3476,0,3476,0,0
Jason Becker: Not Dead Yet,1294,2786,4080,319,2
Yangsi,4008,0,4008,0,0
Free Radicals: A History of Experimental Film,3804,0,3804,1350,1
Storage 24,72,646103,646175,72,1
To Die Is Hard,5129,0,5129,112,1
Guardians of the Galaxy,333176600,439600000,772776600,94320883,4080
The Hunger Games: Mockingjay - Part 1,337135885,418220826,755356711,121897634,4151
Captain America: The Winter Soldier,259766572,454654931,714421503,95023721,3938
The Lego Movie,257760692,210300000,468060692,69050279,3775
Transformers: Age of Extinction,245439076,858614996,1104054072,100038390,4233
Maleficent,241410378,517000000,758410378,69431298,3948
X-Men: Days of Future Past,233921534,512124166,746045700,90823660,3996
Dawn of the Planet of the Apes,208545589,502098977,710644566,72611427,3967
Big Hero 6,222527828,435300000,657827828,56215889,3761
The Amazing Spider-Man 2,202853933,506128390,708982323,91608337,4324
Godzilla,200676069,324300000,524976069,93188384,3952
22 Jump Street,191719337,139614539,331333876,57071445,3306
Teenage Mutant Ninja Turtles,191204754,293800000,485004754,65575105,3845
The Hobbit: The Battle of the Five Armies,255119788,700900000,956019788,54724334,3875
Interstellar,188020017,489443796,677463813,47510360,3561
How to Train Your Dragon 2,177002924,444534595,621537519,49451322,4253
Gone Girl,167767189,201563174,369330363,37513109,3014
Divergent,150947895,137937923,288885818,54607747,3936
Neighbors,150157400,120507734,270665134,49033915,3279
Frozen,400738009,880064273,1280802282,243390,1
Ride Along,134938200,19530702,154468902,41516170,2663
Rio 2,131538435,367242682,498781117,39327869,3948
Lucy,126663600,332200000,458863600,43899340,3173
Lone Survivor,125095601,29707311,154802912,90872,2
The Fault in Our Stars,124872350,182294484,307166834,48002523,3173
Mr. Peabody & Sherman,111506430,164191609,275698039,32207057,3934
300: Rise of an Empire,106580051,231000000,337580051,45038460,3470
The Maze Runner,102427862,245891999,348319861,32512804,3604
Noah,101200044,258000000,359200044,43720472,3567
The Equalizer,101530738,90800000,192330738,34137828,3236
Edge of Tomorrow,100206256,270335000,370541256,28760246,3490
Non-Stop,92168600,130641000,222809600,28875635,3090
Heaven Is for Real,91443253,10444766,101888019,22522221,2417
Fury,85817906,126000000,211817906,23702421,3173
Dumb and Dumber To,86208010,83629000,169837010,36111775,3154
Tammy,84525432,15850000,100375432,21577049,3465
Annabelle,84273813,172773848,257047661,37134255,3185
The Other Woman,83911193,112799203,196710396,24763752,3205
American Hustle,150117807,101054000,251171807,740455,6
Let's Be Cops,82390774,55834177,138224951,17813722,3094
The Monuments Men,78031620,77610030,155641650,22003433,3083
The Wolf of Wall Street,116900694,275100000,392000694,18361578,2537
Penguins of Madagascar,83850911,289664710,373515621,25447444,3764
Hercules,72688614,172131248,244819862,29800263,3595
The Purge: Anarchy,71962800,39965565,111928365,29816675,2805
Night at the Museum: Secret of the Tomb,113746621,249458014,363204635,17100520,3785
"Alexander and the Terrible, Horrible, No Good, Very Bad Day",66954149,33700000,100654149,18360230,3088
Think Like a Man Too,65182182,4999246,70181428,29241911,2225
The Nut Job,64251541,56633986,120885527,19423000,3427
Into the Woods,128002372,84900000,212902372,31051923,2440
Unbroken,115637895,45821402,161459297,30621445,3131
God's Not Dead,60755732,3912142,64667874,9217013,780
Son of God,59700064,11129206,70829270,25601865,3260
Planes: Fire & Rescue,59165787,87800000,146965787,17509407,3826
The Grand Budapest Hotel,59301324,113635617,172936941,811166,4
RoboCop,58607007,184081958,242688965,21681430,3372
Annie,85911262,50942244,136853506,15861939,3116
The Hobbit: The Desolation of Smaug,258366855,700000000,958366855,73645197,3903
Dracula Untold,56280355,160843925,217124280,23514615,2885
Exodus: Gods and Kings,65014513,203161118,268175631,24115934,3503
The Hundred-Foot Journey,54240821,35273632,89514453,10979290,2023
No Good Deed,52543632,1779578,54323210,24250283,2175
Horrible Bosses 2,54445357,53200000,107645357,15457418,3375
Muppets Most Wanted,51183113,29200000,80383113,17005126,3194
Ouija,50856010,52734261,103590271,19875995,2858
Jack Ryan: Shadow Recruit,50577412,84926336,135503748,15451981,3387
The Boxtrolls,50837305,57418465,108255770,17275239,3464
If I Stay,50474843,27800000,78274843,15679190,2907
The Book of Life,50151543,49632013,99783556,17005218,3071
About Last Night,48637684,1808176,50445860,25649011,2253
Into the Storm,47602194,113900000,161502194,17346427,3434
Jersey Boys,47047013,20600000,67647013,13319371,2905
The Judge,47119388,37300000,84419388,13116226,3003
Blended,46294610,81700000,127994610,14284031,3555
The Giver,45090374,21890082,66980456,12305016,3003
Need for Speed,43577636,159700000,203277636,17844939,3115
A Million Ways to Die in the West,43139300,44050456,87189756,16797385,3158
St. Vincent,44137712,10699522,54837234,109878,4
John Wick,43037835,42975221,86013056,14415922,2589
Dolphin Tale 2,42024533,15800000,57824533,15873397,3656
The Expendables 3,39322544,175335033,214657577,15879645,3221
Saving Mr. Banks,83301580,34566404,117867984,413373,15
Earth to Echo,38934842,6746220,45681062,8364658,3230
Sex Tape,38543473,87526036,126069509,14608152,3062
August: Osage County,37738810,36450127,74188937,179302,5
Million Dollar Arm,36457627,2025828,38483455,10515659,3019
Anchorman 2: The Legend Continues,125168368,46296308,171464676,26232425,3507
This Is Where I Leave You,34296320,7000000,41296320,11558149,2868
Paranormal Activity: The Marked Ones,32462372,58432590,90894962,18343611,2867
Nightcrawler,32381217,15017775,47398992,10441000,2766
Chef,31424003,17004045,48428048,204961,6
Get on Up,30703100,2745871,33448971,13585915,2468
3 Days to Kill,30697999,22562231,53260230,12242218,2872
Deliver Us from Evil,30577122,57360693,87937815,9740471,3049
When the Game Stands Tall,30127963,10791,30138754,8381509,2673
The Hunger Games: Catching Fire,424668047,440343699,865011746,158074286,4163
Draft Day,28842237,981962,29824199,9783603,2781
Oculus,27695246,16751041,44446287,12005402,2648
The Secret Life of Walter Mitty,58236838,129896484,188133322,12765508,2909
The Best of Me,26766213,11843455,38609668,10003827,2936
A Walk Among the Tombstones,26307600,32526784,58834384,12758780,2712
That Awkward Moment,26068955,19571188,45640143,8742109,2809
The November Man,25018119,14643800,39661919,7911597,2776
Birdman or (The Unexpected Virtue of Ignorance),42340598,60874496,103215094,424397,4
Boyhood,25352281,22785385,48137666,387618,5
Her,25568251,22949176,48517427,260382,6
Endless Love,23438250,11279923,34718173,13307125,2896
The Theory of Everything,35893537,87833151,123726688,208763,5
Pompeii,23219748,94611883,117831631,10340823,2658
Transcendence,23022309,80016949,103039258,10886386,3455
"As Above, So Below",21321100,20577309,41898409,8632820,2640
Top Five,25317471,800000,26117471,6896593,979
Philomena,37709979,62419893,100129872,128435,4
Brick Mansions,20396829,51019901,71416730,9516855,2647
The Imitation Game,91125683,142430025,233555708,479352,4
Wild,37880356,14621185,52501541,606810,21
Gravity,274092705,449100000,723192705,55785112,3575
"I, Frankenstein",19075290,57725889,76801179,8610441,2753
The Gambler,33680992,5600000,39280992,9129999,2478
The Legend of Hercules,18848538,42430914,61279452,8868318,2104
12 Years a Slave,56671993,131061209,187733202,923715,19
Bears,17780194,3536551,21316745,4776267,1720
Addicted,17390770,143544,17534314,7485346,846
A Haunted House 2,17329486,8029230,25358716,8843875,2310
A Most Wanted Man,17237855,18995662,36233517,2687227,361
Begin Again,16170632,47294229,63464861,134064,5
The Single Moms Club,15973881,391570,16365451,8075111,1896
Devil's Due,15821461,21100099,36921560,8308220,2544
And So It Goes,15160801,10151586,25312387,4642329,1762
Step Up All In,14904384,71261262,86165646,6469857,2072
Beyond the Lights,14618727,0,14618727,6200284,1789
47 Ronin,38362475,113421364,151783839,9910310,2689
America: Imagine the World Without Her,14444502,0,14444502,38608,3
Left Behind,14019924,13385972,27405896,6300147,1825
Frank Miller's Sin City: A Dame to Kill For,13757804,25649812,39407616,6317683,2894
Grudge Match,29807260,15100000,44907260,7021993,2838
Labor Day,13371528,6904284,20275812,5175282,2584
Winter's Tale,12600231,18200000,30800231,7297694,2965
Walking with Dinosaurs 3D,36076121,90470397,126546518,7091938,3231
Nebraska,17654912,10027960,27682872,140401,4
Dallas Buyers Club,27298285,28438303,55736588,260865,9
Belle,10726630,5880945,16607575,106578,4
The Drop,10724389,7933992,18658381,4104552,809
Magic in the Moonlight,10539326,40490035,51029361,412095,17
Sabotage,10508518,11618324,22126842,5272444,2486
Moms' Night Out,10429707,107249,10536956,4311083,1044
PK,10616104,89754000,100370104,3565258,272
The Quiet Ones,8509867,9325295,17835162,3880053,2027
Legends of Oz: Dorothy's Return,8462347,13293071,21755418,3747780,2658
Island of Lemurs: Madagascar,11272213,2794321,14066534,188307,37
Inside Llewyn Davis,13235319,19700000,32935319,405411,4
Vampire Academy,7791979,7850367,15642346,3921742,2676
Bad Words,7779614,24723,7804337,113301,6
Tyler Perry's A Madea Christmas,52543354,853281,53396635,16007634,2194
Foxcatcher,12096300,7110213,19206513,270877,6
Cantinflas,6382924,11583949,17966873,2661253,382
Big Eyes,14482031,14771135,29253166,3001738,1307
Meet the Mormons,6047363,0,6047363,2509808,317
Whiplash,13092000,35890041,48982041,135388,6
Cesar Chavez,5571497,1148428,6719925,2861528,664
The Skeleton Twins,5284309,492331,5776640,380691,15
The Wind Rises,5209580,131244640,136454220,313751,21
Journey to the South Pacific,7653913,7340963,14994876,8137,1
Jerusalem,8020721,1258735,9279456,0,0
Hubble 3D,52522904,21726825,74249729,413477,39
Snowpiercer,4563650,82195262,86758912,171187,8
The Railway Man,4438438,19736447,24174885,61845,4
Dear White People,4404154,229807,4633961,347959,11
The Lunchbox,4235151,7386430,11621581,44542,3
My Old Lady,4013786,6592881,10606667,124680,11
Fading Gigolo,3769873,18936431,22706304,180801,5
Thor: The Dark World,206362140,438421000,644783140,85737841,3841
Ida,3827060,7329776,11156836,55438,3
Calvary,3600006,13287735,16887741,74149,4
Wish I Was Here,3591299,2079477,5670776,484401,68
Ghostbusters,3580343,0,3580343,1756513,784
The Interview,6105175,5677450,11782625,1794666,331
What If,3493000,5033288,8526288,133898,20
The Grand Seduction,3430018,862499,4292517,41433,8
Veronica Mars: The Movie,3322127,163256,3485383,1988351,291
Mommy,3494070,9662786,13156856,473882,62
The Book Thief,21488481,55097835,76586316,105005,4
Before I Go to Sleep,3242457,14427319,17669776,1843347,1902
Rosewater,3128941,42652,3171593,1154303,371
Obvious Child,3123963,201454,3325417,77315,3
Mandela: Long Walk to Freedom,8323085,19662703,27985788,84283,4
Cloudy With a Chance of Meatballs 2,119793567,154532382,274325949,34017930,4001
The Trip to Italy,2880537,3208572,6089109,71712,3
The Identical,2827666,13325,2840991,1587137,1956
The Fluffy Movie: Unity Through Laughter,2827393,0,2827393,1311446,432
Kirk Cameron's Saving Christmas,2783970,0,2783970,992087,410
The Good Lie,2722209,674136,3396345,841422,461
The Pyramid,2756333,14104804,16861137,1369935,589
Space Station 3D,93383953,34979928,128363881,489488,24
The Raid 2,2627209,3939707,6566916,165292,7
Under the Skin,2614251,3121712,5735963,133154,4
The Admiral: Roaring Currents,2589811,135752447,138342258,51431,1
Dragon Ball Z: Battle of Gods,2553002,47908369,50461371,296414,62
Bang Bang,2546172,39499809,42045981,1278690,271
Kick,2472695,2761099,5233794,1071373,180
Captain Phillips,107100855,111690956,218791811,25718314,3020
Kill the Messenger,2450846,2768127,5218973,941809,374
Love Is Strange,2262223,717516,2979739,117276,5
2 States,2238174,1320713,3558887,1073898,135
Le Week-end,2225098,6427115,8652213,43608,3
The Homesman,2429989,1389432,3819421,45433,4
Anchorman 2: The Legend Continues,2184339,916,2185255,1358833,1317
Citizenfour,2800870,979822,3780692,126321,5
The Oscar Nominated Short Films 2014: Live Action,2171849,0,2171849,329505,105
Words and Pictures,2171257,1267617,3438874,87879,10
Gloria,2107925,4353634,6461559,56454,3
The Great Beauty,2852400,21419339,24271739,23442,1
The Immigrant,2025328,3927556,5952884,44064,3
Only Lovers Left Alive,1879534,5729653,7609187,87989,4
Tusk,1826705,55369,1882074,846831,602
Tim's Vermeer,1671377,15540,1686917,49777,4
Persecuted,1558836,0,1558836,851391,736
Fed Up,1538899,7330,1546229,126028,18
Finding Vivian Maier,1514782,869802,2384584,63600,3
Pride,1446634,15252395,16699029,100040,10
Locke,1375769,3714839,5090608,81006,4
Gimme Shelter,1359910,2108,1362018,689070,385
American Sniper,350126372,197300000,547426372,633456,4
Justin Bieber's Believe,6206566,4773591,10980157,2007567,1037
Let There Be Victory,1264515,858289,2122804,840506,195
Singham Returns,1232018,742727,1974745,654045,127
The Past,1331747,11341715,12673462,29270,3
Free Birds,55750480,54636592,110387072,15805237,3736
Selma,52076908,14711000,66787908,571450,19
Repentance,1189612,5349,1194961,501290,152
The Remaining,1169603,1127658,2297261,159143,67
The Invisible Woman,1234254,2752634,3986888,31948,3
Hector and the Search for Happiness,1124445,5213283,6337728,40847,4
Last Vegas,63914167,70488283,134402450,16334566,3065
Inherent Vice,8110975,6600000,14710975,328184,5
The Rover,1114423,1395584,2510007,69302,5
Force Majeure,1359497,2734842,4094339,23309,2
The Captive,1075178,1015434,2090612,407804,132
Laggies,1066981,1312173,2379154,74139,5
50 to 1,1064454,0,1064454,78480,19
Haider,1048143,356164,1404307,508084,119
Third Person,1021398,1603363,2624761,38856,5
Stalingrad,1013945,67302507,68316452,510846,308
The Song,1009620,0,1009620,568596,340
Enemy,1008726,2459498,3468224,16161,1
Awake: The Life of Yogananda,1539680,352238,1891918,18885,1
Delivery Man,30664106,22456240,53120346,7944977,3036
Walking With The Enemy,1112592,0,1112592,331855,258
Shaadi Ke Side Effects,921277,600501,1521778,582672,108
Darker Than Night,870063,5290051,6160114,539867,178
Particle Fever,869838,0,869838,53901,4
Atlas Shrugged: Who Is John Galt?,846704,0,846704,461179,242
Dhoom 3,8031955,80000000,88031955,3423508,239
Kochadaiiyaan,817192,393388,1210580,583172,161
Saw,815324,0,815324,650051,2063
Life Itself,810454,5191,815645,131411,23
Nymphomaniac: Vol. I,785896,12759936,13545832,158369,25
Breakup Buddies,777896,188239700,189017596,230204,20
Palo Alto,767732,151859,919591,63461,4
Alone Yet Not Alone,887851,0,887851,125775,11
The Villain,730530,547578,1278108,414116,104
Land Ho!,727594,0,727594,34319,4
Yves Saint Laurent,723593,20302697,21026290,24207,2
Khoobsurat,710508,665115,1375623,345085,57
Holiday: A Soldier is Never Off Duty,706893,683161,1390054,394797,144
"Men, Women & Children",705908,1000000,1705908,48024,17
Frankie & Alice,695876,0,695876,350647,171
Under the Sea 3D,36262926,19639698,55902624,661185,49
Jackass Presents: Bad Grandpa,102003019,49823528,151826547,32055177,3336
Mr. Turner,3958500,18221285,22179785,109000,5
The Babadook,964413,9348127,10312540,30007,3
Jodorowsky's Dune,647280,0,647280,36018,3
Hasee Toh Phasee,646035,270871,916906,336985,88
Frank,645186,1252177,1897363,16056,1
Mary Kom,621300,218540,839840,370277,139
Finding Fanny,615691,7070093,7685784,515393,121
The Saratov Approach,2146999,0,2146999,137226,23
The Signal,600896,1994726,2595622,155642,120
The Disappearance of Eleanor Rigby: Them,587774,860302,1448076,66941,4
The Tale of The Princess Kaguya,703232,23663424,24366656,54915,3
Forrest Gump,557683,810,558493,398560,337
The Attorney,557236,77990350,78547586,216035,27
23 Blast,549185,0,549185,337091,617
Fleet of Time,569280,93674911,94244191,206591,20
On Any Sunday: The Next Chapter,543044,0,543044,320894,231
Highway,529136,329647,858783,326654,97
Dom Hemingway,523511,784088,1307599,29276,4
A Hard Day's Night,515005,0,515005,220542,102
The One I Love,513447,83486,596933,48059,8
Tracks,510007,5343502,5853509,21544,4
The Two Faces of January,507463,13044488,13551951,43116,6
Born to Be Wild,25978556,15665919,41644475,871478,206
Walking the Camino: Six Ways to Santiago,612717,0,612717,0,0
To the Arctic 3D,14560838,9134550,23695388,270228,50
Ender's Game,61737191,63806833,125544024,27017351,3407
Lee Daniels' The Butler,116632095,60681700,177313795,24637312,2933
In Secret,444179,208049,652228,265586,266
Last Days in Vietnam,466114,0,466114,30500,2
But Always,430760,37608488,38039248,144720,20
Beijing Love Story,428318,65414057,65842375,140106,9
Cold in July,427418,1120212,1547630,40317,6
The German Doctor,418392,3217326,3635718,34259,5
The Pirates,415775,64442449,64858224,26025,1
Blue Jasmine,33405481,65699323,99104804,612064,6
The Bride of Humpty Sharma,380011,366777,746788,380011,101
Joe,373375,2058068,2431443,105881,48
Women Who Flirt,375495,38780637,39156132,74052,26
Glen Campbell: I'll Be Me,365422,0,365422,86741,10
Omar,356000,258444,614444,157000,53
The Face of Love,350006,1456542,1806548,24660,3
Le Chef,342667,8902568,9245235,11290,1
Venus in Fur,373605,7976421,8350026,24761,2
Jimi: All Is by My Side,340911,258929,599840,97008,34
Chinese Puzzle,338523,16629774,16968297,23544,2
I Origins,336472,144762,481234,27652,4
"Like Father, Like Son",334616,36835547,37170163,16044,2
The Guest,332890,2367161,2700051,84527,19
Elaine Stritch: Shoot Me,327452,0,327452,27853,2
Nymphomaniac: Vol. II,327167,4607558,4934725,74978,30
Stranger by the Lake,325196,806045,1131241,27599,2
On My Way,317324,5188381,5505705,10536,1
Happy Ending,313770,45772,359542,198702,129
The Hornet's Nest,312706,0,312706,26550,4
A Five Star Life,306917,442736,749653,15996,1
Mood Indigo,303187,10132135,10435322,26511,2
Innocence,294039,6253610,6547649,235224,490
The Dance of Reality,293680,264956,558636,24768,2
All Is Lost,6263670,7363849,13627519,93583,6
The Last of Robin Hood,288545,0,288545,25821,2
Elsa & Fred,285863,350038,635901,65275,34
Kundo: Age of the Rampant,280958,35660333,35941291,120857,28
"20,000 Days on Earth",279558,1826000,2105558,27879,1
The Unknown Known,276497,25107,301604,64315,18
I'm Your Hero,274579,244695,519274,162404,77
Despicable Me 2,368065385,602700620,970766005,83517315,3997
Night Moves,271755,586758,858513,21488,2
The Love Punch,266588,8099905,8366493,0,0
Life of Crime,265452,1191223,1456675,104300,37
Ernest & Celestine,262075,7849062,8111137,13078,1
Blue Ruin,258384,734929,993313,32608,7
The Green Prince,258237,80971,339208,32698,4
The Zero Theorem,257706,1170656,1428362,83803,63
Action Jackson,256872,58737,315609,171795,125
Alive Inside: A Story of Music and Memory,256682,0,256682,7200,1
The Blue Room,254666,978234,1232900,21809,3
Tazza: The Hidden Card,251555,31026921,31278476,24106,1
A Matter of Faith,680113,0,680113,138677,25
The Galapagos Affair: Satan Came to Eden,247159,0,247159,5185,1
Deepsea Challenge,235659,227300,462959,149879,304
Art and Craft,235037,0,235037,20879,2
Dr. Cabbie,225490,0,225490,118732,220
Diplomacy,230880,3976362,4207242,8518,1
The Suspect,218693,28455437,28674130,86137,20
Supermensch: The Legend of Shep Gordon,213064,7001,220065,23017,4
The Best Man Holiday,70525195,2310515,72835710,30107555,2024
Antarctica: A Year on Ice,288757,0,288757,32238,8
The Breakup Guru,208959,106771304,106980263,62717,12
Rob the Mob,208693,920,209613,13833,1
Under the Electric Sky,207584,0,207584,0,0
I Am Eleven,310116,0,310116,5800,2
Jinn,202348,95033,297381,149337,201
Bethlehem,201700,182970,384670,69700,26
The Double,200406,1462109,1662515,14646,2
A Summer's Tale,198126,0,198126,12863,2
Code Black,190229,0,190229,6319,1
Wei ai zhi jian ru jia jing,271734,45114826,45386560,67967,17
Goodbye to Language,401889,164534,566423,0,0
Out of the Furnace,11330849,4329819,15660668,5220288,2101
Listen Up Philip,200126,0,200126,23284,2
National Gallery,253941,101030,354971,10049,1
We are the Best!,180590,1423683,1604273,17664,3
Anita: Speaking Truth to Power,176979,0,176979,44114,7
Blue Is the Warmest Colour,2199787,17266048,19465835,100316,4
Evangelion: 3.0 You Can,174945,60313399,60488344,110825,82
Horns,173948,3701494,3875442,107544,103
Afternoon of a Faun: Tanaquil Le Clercq,172450,0,172450,15292,2
That Demon Within,172343,20243591,20415934,77130,12
God's Pocket,169976,233737,403713,21482,3
Nas: Time Is Illmatic,164540,0,164540,23200,2
Keep on Keepin' On,163745,0,163745,12930,2
Sinbad: The Fifth Voyage,159862,0,159862,103384,27
Escape Plan,25135965,112192336,137328301,9885732,2883
A Girl Walks Home Alone at Night,491910,54442,546352,0,0
Citizen Koch,153908,0,153908,10200,1
Alan Partridge,153426,9826175,9979601,12664,3
Dancing in Jaffa,151098,159903,311001,10564,2
A Coffee in Berlin,150275,2676058,2826333,3918,1
Godzilla,150191,0,150191,10903,1
Kids for Cash,143178,0,143178,36639,4
Gore Vidal: The United States of Amnesia,140164,0,140164,13744,2
Mistaken for Strangers,138991,114294,253285,87743,9
The Congress,137815,557316,695131,28640,15
The Divine Move,136707,27790164,27926871,49057,11
When Comedy Went to School,369065,0,369065,17001,5
Redwood Highway,134049,0,134049,30,1
The Jewish Cardinal,133232,0,133232,0,0
Raja Natwarlal,131105,125873,256978,83669,73
20 Feet from Stardom,4946445,892923,5839368,54596,3
Bjork: Biophilia Live,127754,305932,433686,0,0
Make Your Move,125106,1458581,1583687,81172,142
Knights of Badassdom,123854,0,123854,17449,13
Afflicted,121179,0,121179,69447,44
Finding Fela,120980,31366,152346,0,0
God the Father,113276,0,113276,15037,1
The Liberator,113067,4969031,5082098,69992,76
Rich Hill,111376,0,111376,9635,1
Galapagos,18630372,10718800,29349172,0,0
Penton: The John Penton Story,112159,0,112159,0,0
Anohana the Movie: The Flower We Saw That Day (Ano hi mita hana no namae wo bokutachi wa mada shiran,109630,0,109630,37480,17
Ivory Tower,106771,0,106771,17857,2
Girl Rising,1727259,0,1727259,81640,34
God Help the Girl,102757,320549,423306,11330,2
The Golden Era,102931,25995,128926,50242,15
Coherence,102617,37128,139745,17000,2
Korengal,101310,0,101310,14630,1
One Chance,101196,10799238,10900434,33405,43
Beyond Sight: The Derek Rabelo Story,101074,0,101074,26840,2
The Best Offer,100035,20496315,20596350,2595,1
The Overnighters,110763,0,110763,4324,1
Child's Pose,97170,896956,994126,12955,2
A Most Violent Year,5749134,6257936,12007070,172788,4
The Anonymous People,284147,0,284147,0,0
The Way He Looks,101451,1106390,1207841,26334,9
Personal Tailor,375892,115750566,116126458,112224,9
Cuban Fury,92384,300321,392705,57105,79
Generation War,91595,0,91595,7386,1
Girl on a Bicycle,91401,84871,176272,37610,52
Pump,89787,0,89787,42200,3
Breathe In,89661,391418,481079,15324,18
Life After Beth,88273,186444,274717,15843,2
Hiroshima Mon Amour,96439,0,96439,18494,5
Enough Said,17550872,7738000,25288872,232800,4
Ode To My Father,2300121,96785170,99085291,33880,1
Visitors,84577,0,84577,9094,1
Watermark,84464,62108,146572,7724,2
12 O'Clock Boys,82614,0,82614,44108,21
Water & Power,82312,0,82312,39428,16
Advanced Style,87879,119352,207231,6500,1
Fort McCoy,78948,0,78948,4070,2
Percy Jackson: Sea of Monsters,68559554,131290761,199850315,14401054,3031
Whitey: United States of America v. James J. Bulger,75881,0,75881,14287,3
Just a Sigh,75531,1330800,1406331,11500,2
Better Living Through Chemistry,75143,45680,120823,46435,61
The Broken Circle Breakdown,175058,5815696,5990754,7100,1
Flamenco Flamenco,71732,0,71732,1259,1
Veil of Tears,72078,0,72078,44358,8
A Letter to Momo,71712,6677176,6748888,4596,1
"Je t'aime, je t'aime",71717,0,71717,12869,1
Kill Your Darlings,1030064,847860,1877924,53452,4
The Square,124244,0,124244,16359,1
The Better Angels,70918,0,70918,4246,2
Final: The Rapture,124561,0,124561,31900,2
Zero Motivation,116044,22565,138609,9427,1
Take Me to the River,68598,0,68598,25588,12
For No Good Reason,67421,0,67421,4516,2
The Notebook,66559,179998,246557,3127,2
Through a Lens Darkly: Black Photographers and the Emergence of a People,65169,0,65169,9456,1
The Art of the Steal,64065,13385,77450,40003,60
Jealousy,63946,0,63946,5533,1
Heroic Antics,63649,27136,90785,32831,16
No Tears for the Dead,63063,0,63063,8329,1
The Last Sentence,62506,265499,328005,9020,2
Maidentrip,68243,0,68243,1622,1
Young & Beautiful,61067,9696350,9757417,4607,1
Siddharth,60537,8773,69310,4564,1
Bicycling with Molière,59874,11064055,11123929,3896,1
Frontera,59696,0,59696,10962,3
Wetlands,59478,752,60230,6488,1
Cheap Thrills,59424,0,59424,18638,2
Walk of Shame,59209,8063781,8122990,39751,51
The One I Wrote for You,58872,0,58872,48643,49
The Conformist,58657,0,58657,0,0
Rudderless,58293,487856,546149,37440,18
Deep Sea,46412757,51818148,98230905,700213,43
Borgman,57474,994536,1052010,5317,2
The Rocket,56823,392241,449064,4621,2
Ilo Ilo,56773,1159408,1216181,8775,2
The Bag Man,56574,405206,461780,29231,2
Big Men,56286,0,56286,7539,1
In Bloom,56092,41144,97236,9280,2
Hellion,55708,0,55708,7601,1
Starred Up,54915,2970274,3025189,10358,2
Low Down,54051,0,54051,5278,1
Hateship Loveship,54030,28978,83008,6015,1
"1,000 Times Good Night",53895,2495673,2549568,24120,24
At Middleton,53837,0,53837,33768,20
Half of a Yellow Sun,54529,251864,306393,4843,1
Ping Pong Summer,52909,0,52909,25781,17
To Be Takei,52823,0,52823,22846,22
Song of the Sea,857522,3333148,4190670,21910,2
The Missing Picture,52164,24769,76933,10148,5
The Retrieval,50257,0,50257,7232,1
A Touch of Sin,154120,700771,854891,19867,2
The Discoverers,50020,0,50020,7166,1
NOW: In the Wings on a World Stage,49591,0,49591,21500,3
Lucky Them,48995,0,48995,3728,1
The Internet's Own Boy: The Story of Aaron Swartz,48911,0,48911,21705,12
A Birder's Guide to Everything,48713,0,48713,21602,8
American Mustang,48700,0,48700,7906,1
Decoding Annie Parker,48390,11658,60048,16781,13
The Armstrong Lie,383294,211100,594394,28992,5
Alphaville,47696,0,47696,7298,1
A Master Builder,46874,0,46874,7017,1
Filmistaan,45406,0,45406,31113,24
Return to the Hiding Place,45405,0,45405,36942,5
Ai Weiwei: The Fake Case,45255,0,45255,5066,1
There's No Place Like Utopia,45254,0,45254,30710,1
The Dog,44581,0,44581,12431,3
If You Build It,43393,0,43393,4949,1
Road to Ninja - Naruto the Movie,43171,197516,240687,19017,40
Next Goal Wins,43089,0,43089,2568,5
Interior. Leather Bar.,42534,0,42534,5218,1
Blood Ties,42472,2523963,2566435,26912,28
Long Live Freedom,48541,947449,995990,5272,2
Leviathan,1092800,3346681,4439481,15200,2
The Last of the Unjust,40563,22573,63136,14328,8
She's Beautiful When She's Angry,421573,0,421573,10505,1
Teenage,40169,0,40169,8000,1
Child of God,39324,0,39324,27630,8
The Expedition to the End of the World,39115,0,39115,6635,1
7 Boxes,38106,332786,370892,6447,6
Dead Snow 2: Red vs. Dead,37473,1150004,1187477,17331,25
Not Cool,36026,0,36026,10329,1
Homefront,20158898,28290518,48449416,6915241,2570
Bettie Page Reveals All,108118,0,108118,4846,1
That Man from Rio,35144,0,35144,11214,2
Beneath the Harvest Sky,34768,0,34768,16768,8
This Ain't No Mouse Music,34754,0,34754,15982,4
Tiger & Bunny: The Rising,34471,6134146,6168617,23171,18
Filth,34411,8343576,8377987,7526,3
Rocks in My Pockets,34236,0,34236,4674,1
Sweet Dreams,59403,0,59403,0,0
White Bird in a Blizzard,33821,435880,469701,6302,4
It Felt Like Love,33817,0,33817,8211,1
Rakuen Tsuiho: Expelled from Paradise,34510,0,34510,18869,13
K: Missing Kings,33531,792792,826323,0,0
Big Bad Wolves,33232,258007,291239,6342,6
A Field in England,32846,64349,97195,9498,13
Le Jour Se Leve,35321,0,35321,11864,3
For a Woman,32286,1220130,1252416,6530,2
The Hero of Color City,32188,0,32188,24260,69
Bird People,32111,834100,866211,7443,1
Six Dance Lessons in Six Weeks,106323,0,106323,12542,7
Abuse of Weakness,31611,140049,171660,9140,1
Sagrada: The Mystery of Creation,58755,0,58755,2009,1
Documented,30662,0,30662,5422,1
Happy Christmas,30312,0,30312,7523,4
Jimmy P: Psychotherapy Of A Plains Indian,30283,1440299,1470582,7191,1
Southern Baptist Sissies,30160,0,30160,5200,1
A Long Way Off,30104,0,30104,1926,1
Manakamana,30029,0,30029,3635,1
Yellow Day,29656,0,29656,29144,1
Cutie and the Boxer,200036,0,200036,21098,3
Othello,28980,0,28980,6010,2
Stations of the Elevated,28516,0,28516,9423,1
Muscle Shoals,696241,13174,709415,13901,1
Closed Curtain,28098,5637,33735,5002,1
T-Rex: Back to the Cretaceous,53354743,50605624,103960367,0,0
The Act of Killing,486919,235795,722714,27450,1
Lilting,27054,220323,247377,1567,1
Last Weekend,27053,0,27053,2661,1
Monk with a Camera,45938,0,45938,0,0
Elena,25788,0,25788,10341,1
Christian Mingle,25480,0,25480,19836,15
Short Peace,22862,605945,628807,0,0
Adult World,25368,12519,37887,3783,2
The King and the Mockingbird,27513,0,27513,3721,1
Born to Fly: Elizabeth Streb vs. Gravity,24630,0,24630,8406,1
Emoticon ;),23881,0,23881,11761,3
Happy Valley,23868,0,23868,9047,4
Level Five,27000,0,27000,7161,2
Believe Me,23419,0,23419,0,0
Video Games: The Movie,23043,0,23043,12759,25
Wadjda,1347747,5151422,6499169,41253,3
Two Lives,22620,1626640,1649260,1303,1
Grand Piano,22555,1595530,1618085,2964,2
May in the Summer,22004,119601,141605,10157,8
Bright Days Ahead,21770,647315,669085,4919,4
Memphis,21286,0,21286,0,0
The Counselor,16973715,54035619,71009334,7842930,3044
Lekar Hum Deewana Dil,20874,0,20874,14418,50
The Great Flood,20694,0,20694,3596,1
I Am Divine,81497,34242,115739,0,0
The Decent One,21327,13955,35282,0,0
Run & Jump,20061,37128,57189,3944,2
The Past is a Grotesque Animal,20056,0,20056,0,0
Guardian Angel,19480,0,19480,12624,2
A Picture of You,19480,0,19480,5650,1
Uzumasa Limelight,19597,0,19597,10090,13
Peter Brook: The Tightrope,19365,0,19365,6768,1
Watchers of the Sky,19339,0,19339,7473,4
The Kill Team,18983,0,18983,0,0
Why Don't You Play in Hell?,28534,1237338,1265872,5060,3
Test,18823,0,18823,0,0
Tasting Menu,18686,132032,150718,6010,5
Two Night Stand,18612,473720,492332,15600,5
Faust,58132,0,58132,10030,2
The Passionate Thief,31539,0,31539,8677,1
"Two Days, One Night",1436243,7580679,9016922,30700,2
Who is Dayani Cristal?,18190,0,18190,5712,2
Journey to the West,18058,205619125,205637183,7456,7
Tosca's Kiss,18236,0,18236,418,1
Kelly & Cal,17702,0,17702,5387,1
The Homestretch,17306,0,17306,8373,1
Stand Clear of the Closing Doors,17282,0,17282,7000,1
The Principle,89543,0,89543,8657,1
Accident,17161,0,17161,5798,1
Cold Comes the Night,16971,7761,24732,11603,21
Hank and Asha,16878,0,16878,6192,1
Burning Bush,16731,64212,80943,0,0
The Sacrifice,20945,0,20945,0,0
Magician: The Astonishing Life and Work of Orson Welles,16400,0,16400,7130,2
Levitated Mass,16086,0,16086,4589,1
Going Attractions: The Definitive Story of the American Drive-in Movie,52458,0,52458,0,0
Barefoot,15071,0,15071,11767,18
Horses of God,14817,0,14817,2251,1
Last Passenger,14806,39304,54110,9326,10
Exhibition,14344,34,14378,0,0
Black Nativity,7018189,435996,7454185,3669530,1516
13 Sins,13809,813104,826913,9261,45
The Pretty One,13769,0,13769,1484,1
Sol LeWitt,13146,0,13146,4051,1
Inequality for All,1205273,0,1205273,140888,28
Fifi Howls from Happiness,13614,0,13614,2728,1
War of the Worlds: Goliath,13385,0,13385,13385,18
A Long Way Down,13347,7244595,7257942,1426,1
The Punk Singer,122742,23258,146000,24729,3
Camp X-Ray,13302,66322,79624,1316,1
Days and Nights,13243,0,13243,6003,1
The Pleasures of Being Out of Step,13137,0,13137,1846,1
On Tour with Pina Bausch,18016,0,18016,1756,1
Alien Abduction,12897,69828,82725,10514,13
NightLights,21147,0,21147,6414,3
Coming Up Roses,20567,0,20567,6432,2
Special ID,12666,29127270,29139936,6153,10
Bhopal: A Prayer for Rain,12628,0,12628,5948,1
Boy Meets Girl,12589,0,12589,0,0
K2: Siren of the Himalayas,12959,0,12959,1421,2
Fire in the Blood,28994,0,28994,4856,1
Touch the Wall,12156,0,12156,6200,2
Cousin Jules,29337,0,29337,5135,1
Wolves,12139,479015,491154,0,0
In No Great Hurry: 13 Lessons in Life with Saul Leiter,12133,0,12133,6100,1
A Tale of Winter,23268,29163,52431,3802,1
The French Minister,12027,5574619,5586646,3800,1
Queen Margot,12005,0,12005,4985,1
Is the Man Who Is Tall Happy?,137042,0,137042,31800,3
Falcon Rising,11774,255702,267476,8691,10
Living Is Easy with Eyes Closed,11600,3063569,3075169,11600,1
You're Not You,11486,883478,894964,9226,5
The Great Invisible,11428,0,11428,2348,3
The Final Member,11428,0,11428,2064,7
The Amazing Catfish,11342,297007,308349,733,1
History of Jazz: Oxygen for the Ears,23048,0,23048,7566,3
Dishkiyaoon,11288,0,11288,8173,11
Policeman,11263,27000,38263,7379,2
PAY 2 PLAY: Democracy's High Stakes,11021,0,11021,2233,1
The Players,10854,24618298,24629152,6674,50
As It Is in Heaven,10850,0,10850,531,1
"Norte, the End of History",10457,0,10457,2164,1
Money for Nothing: Inside the Federal Reserve,88045,0,88045,0,0
American Promise,146702,0,146702,18300,2
The Endless Summer,10233,0,10233,0,0
Before I Disappear,10078,0,10078,2676,1
Kabbalah Me,9816,0,9816,2196,1
Marius,9781,2240000,2249781,0,0
Stray Dogs,10433,3140,13573,2998,1
Contempt,43763,0,43763,8322,1
On the Other Side of the Tracks,9572,25100000,25109572,5923,50
In the House of Flies,9480,0,9480,3500,4
Museum Hours,561457,77664,639121,29400,2
Go for Sisters,70495,0,70495,6001,2
Free the Mind,157201,11715,168916,12215,1
Radio Free Albemuth,9365,0,9365,5553,10
Life of Riley,11616,2411763,2423379,0,0
Honeymoon,9318,15025,24343,4131,2
The Sacrament,9221,0,9221,583,1
The Pervert's Guide to Ideology,67966,146347,214313,9165,1
The Cabinet of Dr. Caligari,8811,0,8811,0,0
Fanny,8735,362922,371657,1872,1
Comet,8623,10907,19530,0,0
The Mystery of Happiness,8528,3207846,3216374,382,2
The Quitter,8512,0,8512,5588,1
Canopy,8462,0,8462,3042,1
Almost Human,8447,161,8608,2722,2
Red Hollywood,8426,0,8426,4760,1
Love is in the Air,8425,3213129,3221554,4937,6
Eternity: The Movie,8350,0,8350,1582,1
Don Jon,24477704,14961651,39439355,8677009,2422
The Empty Hours,8244,234,8478,1366,1
Gladiators of Rome,8201,10071000,10079201,1920,1
Actress,19365,0,19365,4880,1
Next Year Jerusalem,8093,0,8093,2590,1
Rigor Mortis,7865,3009039,3016904,7865,10
Archipelago,7791,0,7791,0,0
Faith Connections,9111,0,9111,0,0
Come Back to Me,7744,0,7744,4156,10
Iceman,7679,26026238,26033917,4698,6
Gringo Trails,8349,0,8349,158,1
Bad Blood,35176,8582,43758,8482,1
The Little Bedroom,7440,0,7440,2981,1
Raze,7429,0,7429,3453,2
Concerning Violence,12680,0,12680,0,0
I Am Ali,7205,0,7205,4178,11
The Strange Color of Your Body's Tears,7182,0,7182,1535,2
ABCs of Death 2,7171,0,7171,4022,17
Stage Fright,7078,0,7078,3562,11
Plot for Peace,7051,32760,39811,2554,2
Camille Claudel 1915,35296,625059,660355,5106,1
Very Good Girls,6940,4023,10963,4102,9
The Olivia Experiment,15122,0,15122,2754,2
"No God, No Master",6796,0,6796,0,0
Before You Know It,6717,0,6717,1591,1
Will You Still Love Me Tomorrow?,6694,86352,93046,2969,3
Pioneer,6871,2640949,2647820,1857,2
Aatsinki: The Story of Arctic Cowboys,6601,0,6601,2842,1
Life of a King,6547,37614,44161,4231,16
Jews of Egypt,6505,0,6505,2179,1
Revenge of the Mekons,11861,0,11861,2354,1
Magnificent Desolation: Walking on the Moon 3D,34137524,6201878,40339402,479587,80
The Adventurer: The Curse of the Midas Box,6399,122072,128471,4756,82
The Christmas Candle,2258620,218155,2476775,68655,5
The Immortalists,9331,0,9331,0,0
Love & Air Sex,6047,0,6047,0,0
Life Partners,8265,0,8265,2665,3
Cavemen,5948,0,5948,3544,12
Gang of Ghosts,5906,0,5906,4520,20
The Strange Little Cat,5885,6071,11956,3594,1
Infliction,5875,0,5875,816,1
The Bride Wore Black,44566,0,44566,6463,1
The Family,36918811,41500000,78418811,14034764,3091
"2 Autumns, 3 Winters",5819,25166,30985,2163,1
The Devil's Hand,5746,1422748,1428494,4239,17
Papirosen,5658,0,5658,0,0
Kid Cannabis,5565,0,5565,5565,1
Gabrielle,5534,400722,406256,3024,1
Flex Is Kings,5418,0,5418,3152,1
The Only Real Game,5384,0,5384,1130,1
The Selfish Giant,12189,1101838,1114027,2589,3
At Berkeley,31736,0,31736,5069,2
Return to Nuke 'Em High Volume 1,5122,0,5122,3226,1
The Sleepwalker,5012,0,5012,2636,1
Inside the Mind of Leonardo,10600,0,10600,0,0
The Worst Movie Ever!,25206,0,25206,11,1
Nothing Bad Can Happen,4870,0,4870,2853,4
"Half The Road: The Passion, Pitfalls & Power of Women's Professional Cycling",4783,0,4783,1613,2
Death Metal Angola,4674,0,4674,895,1
Short Term 12,1013100,632064,1645164,56206,4
Smiling Through the Apocalypse,4560,0,4560,2590,1
Unrelated,4529,0,4529,0,0
The Truth About Emanuel,4404,0,4404,0,0
Anna,4288,1252854,1257142,2541,15
Manuscripts Don't Burn,6295,0,6295,0,0
Free the Nipple,4198,0,4198,606,1
What's in a Name?,8111,31295469,31303580,0,0
Thunder and the House of Magic,4091,64193114,64197205,4091,10
Justice Is Mind,14360,0,14360,5418,1
Puella Magi Madoka Magica the Movie Part III: The Rebellion Story,375627,19169007,19544634,189514,37
Maidan,3909,0,3909,1847,1
Beyond Outrage,3878,17023637,17027515,1938,1
Swim Little Fish Swim,3877,71627,75504,0,0
Hollidaysburg,3861,0,3861,1713,1
More Than Honey,79772,1524837,1604609,5225,1
The Word,3648,0,3648,3648,1
Stop The Pounding Heart,3642,0,3642,2363,1
Hide Your Smiling Faces,3576,0,3576,0,0
Evolution of a Criminal,3568,0,3568,0,0
Locker 13,3496,0,3496,2468,3
The Hacker Wars,3470,0,3470,2958,1
Let the Fire Burn,64489,0,64489,5226,1
Aftermath,3451,0,3451,1124,1
Life's a Breeze,3450,0,3450,1361,2
Little Fugitive,29505,0,29505,9040,1
Age of Uprising: The Legend of Michael Kohlhaas,3313,810237,813550,0,0
Linsanity,302645,30345,332990,99462,9
Goodbye to All That,16986,0,16986,0,0
Oldboy,2193658,2993109,5186767,885382,583
The Girl on the Train,3124,0,3124,211,1
Northern Lights,9453,0,9453,2256,1
Showrunners: The Art of Running a TV Show,3100,0,3100,3100,1
What Now? Remind Me,3089,0,3089,1434,1
Fatal Assistance,3000,0,3000,3000,1
Mississippi Mermaid,33216,0,33216,3668,1
V/H/S Viral,2756,79653,82409,1221,4
Black Out,2734,0,2734,1749,10
Tip Top,6050,4151,10201,0,0
The Lovely Month of May,55038,0,55038,10662,3
Mercedes Sosa: The Voice of Latin America,2648,37995,40643,1415,1
Refuge,2631,0,2631,1274,1
Indigo Children,2621,0,2621,1829,1
Jake Squared,2592,0,2592,1681,1
McCanick,2572,0,2572,1929,8
"If You Don't, I Will",9719,0,9719,1707,1
The Wait,2480,0,2480,161,1
The Protector 2,2463,3397327,3399790,270,1
To Die Is Hard,5129,0,5129,112,1
Evergreen: The Road to Legalization,2363,0,2363,189,1
Moebius,2340,7914,10254,876,1
Design Is One: The Vignellis,16386,0,16386,4236,1
Trouble Every Day,9189,0,9189,2984,1
Missionary,2120,0,2120,2120,10
A Grin Without A Cat,43616,0,43616,8449,1
The Wild Child,65051,0,65051,6680,1
The Right Kind of Wrong,2098,206007,208105,593,1
Far from Vietnam,8132,0,8132,1125,1
Algorithms,2021,0,2021,317,1
La Camioneta: The Journey of One American School Bus,18558,0,18558,0,0
Here Comes the Devil,4534,0,4534,783,2
Two-Bit Waltz,2540,0,2540,136,1
Austenland,2159041,154468,2313509,40662,4
Mr. Pip,1714,976141,977855,1714,10
More Than the Rainbow,1677,0,1677,1082,1
The Wicker Man,60891,0,60891,5493,1
Summer in February,1624,603779,605403,0,0
The End of Time,4375,0,4375,1468,1
Paradise: Hope,6701,450431,457132,2664,1
Harry Dean Stanton: Partly Fiction,23959,0,23959,6330,2
Rhymes for Young Ghouls,1529,0,1529,141,2
Postman Pat: The Movie,1519,7100936,7102455,1254,2
The Last Days on Mars,24084,163107,187191,4608,3
Souldier,1500,0,1500,900,2
Ragnarok,1369,3719976,3721345,522,1
People of a Feather,5677,0,5677,2413,1
The Tower,1117,3188,4305,726,1
Le Amiche,68167,0,68167,10092,1
Anything for Alice,1092,3386490,3387582,738,1
We Are the Giant,1088,0,1088,1088,2
The Butterfly Room,1081,0,1081,1081,1
Viola,21818,0,21818,6109,1
Demi-soeur,943,1250699,1251642,634,1
A People Uncounted,930,0,930,390,1
The Color Wheel,19001,0,19001,3884,2
Jackpot,806,0,806,806,2
Grand départ,677,261735,262412,339,1
Summer,43839,0,43839,4957,1
Jamel Shabazz Street Photographer,17992,0,17992,7105,1
The Trials of Muhammad Ali,59081,0,59081,2980,1
God Loves Uganda,51229,0,51229,7300,1
An Oversimplification of Her Beauty,71906,0,71906,10055,2
The Last Time I Saw Macao,6095,0,6095,2838,1
Skinless,400,0,400,168,1
Four Adventures of Reinette and Mirabelle,22039,0,22039,5051,1
You Ain't Seen Nothin' Yet,18929,1147811,1166740,5343,2
Finding Mr. Right,6945,84105088,84112033,3430,3
Computer Chess,102041,25811,127852,9683,2
Dear Mr. Watterson,23899,0,23899,6199,5
Big Sur,37466,0,37466,16835,13
Some Velvet Morning,6420,0,6420,0,0
Sound City,422853,98328,521181,62842,16
Jurassic World,652270625,1018130012,1670400637,208806270,4274
Star Wars: Episode VII - The Force Awakens,936662225,1131561399,2068223624,247966675,4134
Avengers: Age of Ultron,459005868,943800000,1402805868,191271109,4276
Inside Out,356461711,501149463,857611174,90440272,3946
Furious 7,353007020,1162040651,1515047671,147187040,4004
American Sniper,350126372,197300000,547426372,633456,4
Minions,336045770,823352627,1159398397,115718405,4301
The Hunger Games: Mockingjay - Part 2,281723902,376620235,658344137,102665981,4175
The Martian,228433663,401728227,630161890,54308575,3831
Cinderella,201151353,341200000,542351353,67877361,3845
Spectre,200074609,680600000,880674609,70403148,3929
Mission: Impossible - Rogue Nation,195042377,487671890,682714267,55520089,3956
Pitch Perfect 2,184296230,102847849,287144079,69216890,3473
Ant-Man,180202163,339109802,519311965,57225526,3856
Home,177397510,208644097,386041607,52107731,3708
Hotel Transylvania 2,169700110,305099890,474800000,48464322,3754
Fifty Shades of Grey,166167230,403484237,569651467,85171450,3646
The SpongeBob Movie: Sponge Out of Water,162994032,162192000,325186032,55365012,3641
Straight Outta Compton,161197785,40437206,201634991,60200180,2757
San Andreas,155190832,318800000,473990832,54588173,3777
Mad Max: Fury Road,153636354,221100000,374736354,45428128,3702
The Divergent Series: Insurgent,130179072,166823455,297002527,52263680,3875
Kingsman: The Secret Service,128261724,286089822,414351546,36206331,3204
The Peanuts Movie,130178411,116054702,246233113,44213073,3897
Spy,110825712,124840507,235666219,29085719,3711
The Good Dinosaur,123087120,209120551,332207671,39155217,3749
Trainwreck,110212700,30583093,140795793,30097040,3158
Creed,109767581,63800000,173567581,29632823,3404
Tomorrowland,93436322,115599346,209035668,33028165,3972
Get Hard,90411453,21300000,111711453,33803253,3175
Terminator Genisys,89760956,350842581,440603537,27018486,3758
Taken 3,89256424,237222717,326479141,39201657,3594
Maze Runner: The Scorch Trials,81697192,230598864,312296056,30316510,3791
Ted 2,81476385,134387221,215863606,33507870,3442
Goosebumps,80080379,78180573,158260952,23618556,3501
Pixels,78747585,166127224,244874809,24011616,3723
Paddington,76271832,206098303,282370135,18966676,3303
The Intern,75764672,118800000,194564672,17728313,3305
The Imitation Game,91125683,142430025,233555708,479352,4
Paul Blart: Mall Cop 2,71038190,36550035,107588225,23762435,3633
Bridge of Spies,72313754,93164594,165478348,15371203,2811
War Room,67790117,5477757,73267874,11351389,1135
Magic Mike XXL,66013057,51800000,117813057,12857184,3355
The Hobbit: The Battle of the Five Armies,255119788,700900000,956019788,54724334,3875
The Visit,65206105,33243957,98450062,25427560,3069
Daddy's Home,150357137,92429000,242786137,38740203,3271
The Wedding Ringer,64460211,15339669,79799880,20649306,3003
Into the Woods,128002372,84900000,212902372,31051923,2440
Black Mass,62575678,37200000,99775678,22635037,3188
Vacation,58884188,48344033,107228221,14681108,3411
The Perfect Guy,57027435,3245738,60273173,25888154,2221
Fantastic Four,56117548,111765333,167882881,25685737,3995
Alvin and the Chipmunks: The Road Chip,85886987,148911649,234798636,14287159,3653
Focus,53862963,104900000,158762963,18685137,3323
Unbroken,115637895,45821402,161459297,30621445,3131
Southpaw,52421953,39548874,91970827,16701294,2772
Insidious: Chapter 3,52218558,60765331,112983889,22692741,3002
Selma,52076908,14711000,66787908,571450,19
Sisters,87044645,17966408,105011053,13922855,2962
Poltergeist,47425125,48012869,95437994,22620386,3240
Jupiter Ascending,47387723,136500000,183887723,18372372,3181
Sicario,46889293,37983151,84872444,401288,6
The Man from U.N.C.L.E.,45445109,61600000,107045109,13421036,3638
"McFarland, USA",44482410,1227649,45710059,11020798,2755
Night at the Museum: Secret of the Tomb,113746621,249458014,363204635,17100520,3785
The Gift,43787265,15191388,58978653,11854273,2503
Everest,43482270,159945314,203427584,7222035,545
The Night Before,43047372,9348624,52395996,9880536,2960
Max,42656255,1311000,43967255,12155254,2855
The Age of Adaline,42629776,23033500,65663276,13203458,2991
Krampus,42725475,18823232,61548707,16293325,2902
The Longest Ride,37446117,25498698,62944815,13019686,3366
The Boy Next Door,35423380,17002475,52425855,14910105,2602
Pan,35088320,93300000,128388320,15315435,3515
Hot Pursuit,34580201,16800000,51380201,13942258,3003
The DUFF,34030343,9679401,43709744,10809149,2575
Woman in Gold,33307793,28311980,61619773,2091551,258
The Second Best Exotic Marigold Hotel,33078266,52900000,85978266,8540370,1573
Unfriended,32482090,30400000,62882090,15845115,2739
Entourage,32363404,16900000,49263404,10283250,3108
Paper Towns,32000304,53511996,85512300,12650140,3031
Chappie,31569268,71242621,102811889,13346782,3201
Crimson Peak,31090320,43589502,74679822,13143310,2984
A Walk in the Woods,29504281,7956993,37461274,8246267,1960
Annie,85911262,50942244,136853506,15861939,3116
Joy,56451232,44682827,101134059,17015168,2896
Sinister 2,27740955,25588195,53329150,10542116,2766
The Last Witch Hunter,27367660,119569250,146936910,10812861,3082
No Escape,27288872,27130000,54418872,8111264,3355
Ricki and the Flash,26822144,14503184,41325328,6610961,1603
The Woman in Black 2: Angel of Death,26501323,22352982,48854305,15027415,2602
Run All Night,26461644,45100000,71561644,11012305,3171
Love the Coopers,26302731,16124181,42426912,8317545,2603
Spotlight,45055776,53634478,98690254,295009,5
The Lazarus Effect,25801570,12555322,38356892,10203437,2666
Ex Machina,25442958,11426456,36869414,237264,4
The Big Short,70259870,63181000,133440870,705527,8
The Hunger Games: Mockingjay - Part 1,337135885,418220826,755356711,121897634,4151
In the Heart of the Sea,25020758,68900000,93920758,11053366,3103
The Gallows,22764410,20200000,42964410,9808463,2720
Hitman: Agent 47,22467450,59880206,82347656,8326530,3261
Project Almanac,22348241,10865000,33213241,8310252,2893
Black or White,21571189,262778,21833967,6213362,1823
Aloha,21067116,5182904,26250020,9670235,2815
Secret in Their Eyes,20180155,14674835,34854990,6652996,2392
Brooklyn,38322743,23753398,62076141,187281,5
Shaun the Sheep Movie,19375982,86833396,106209378,4038962,2320
Still Alice,18754371,26024824,44779195,197000,12
Paranormal Activity: The Ghost Dimension,18300124,60603000,78903124,8070493,1656
Wild,37880356,14621185,52501541,606810,21
Birdman or (The Unexpected Virtue of Ignorance),42340598,60874496,103215094,424397,4
Big Hero 6,222527828,435300000,657827828,56215889,3761
Steve Jobs,17766658,16675215,34441873,521522,4
Mr. Holmes,17737646,11617557,29355203,2434908,361
Dope,17506470,480311,17986781,6100010,2002
Concussion,34542474,14081098,48623572,10513749,2841
Seventh Son,17223265,96955348,114178613,7217640,2875
Monkey Kingdom,16432322,407341,16839663,4577861,2012
The Transporter Refueled,16029670,56600000,72629670,7355622,3434
Point Break,28782481,104936230,133718711,9800252,2910
The Gambler,33680992,5600000,39280992,9129999,2478
It Follows,14674076,6854517,21528593,160089,4
American Ultra,14440985,12821389,27262374,5454284,2778
Woodlawn,14394097,7520,14401617,4002226,1553
Burnt,13651946,22954797,36606743,5002521,3003
The Hateful Eight,54117416,101642701,155760117,4610676,100
Do You Believe?,12985600,1425098,14410698,3591282,1320
The Theory of Everything,35893537,87833151,123726688,208763,5
Love & Mercy,12551031,16090745,28641776,2122177,481
Strange Magic,12429583,1173870,13603453,5504441,3020
Hot Tub Time Machine 2,12314651,767000,13081651,5963324,2880
Self/less,12279691,19527465,31807156,5403460,2353
Far from the Madding Crowd,12236500,17993477,30229977,164985,10
The 33,12227722,15744301,27972023,5787266,2452
The Gunman,10664749,13512388,24177137,5028702,2816
Unfinished Business,10219501,4211752,14431253,4772613,2777
The Walk,10137502,51044440,61181942,1560299,448
Penguins of Madagascar,83850911,289664710,373515621,25447444,3764
Exodus: Gods and Kings,65014513,203161118,268175631,24115934,3503
Huevos: Little Rooster's Egg-cellent Adventure,9080818,16811743,25892561,3424702,395
Interstellar,188020017,489443796,677463813,47510360,3561
Amy,8413144,15292905,23706049,222500,6
Big Eyes,14482031,14771135,29253166,3001738,1307
"Dragon Ball Z: Resurrection ""F""",8008363,53759827,61768190,1817937,183
Blackhat,8005980,11646077,19652057,3901815,2567
Bajrangi Bhaijaan,8178001,67369183,75547184,2425000,257
Mortdecai,7696134,39579561,47275695,4200586,2648
While We're Young,7587485,9699824,17287309,227688,4
Whiplash,13092000,35890041,48982041,135388,6
I'll See You in My Dreams,7449681,2831,7452512,52091,3
The Green Inferno,7192291,5474158,12666449,3520626,1540
Our Brand Is Crisis,7002261,1525397,8527658,3238433,2202
Inherent Vice,8110975,6600000,14710975,328184,5
Grandma,6980524,224549,7205073,115540,4
Trumbo,7857741,3572284,11430025,74177,5
Me and Earl and the Dying Girl,6758416,2316333,9074749,196496,15
Little Boy,6485961,11086328,17572289,2750356,1045
The Loft,6002684,5013759,11016443,2747342,1841
Victor Frankenstein,5775076,28452222,34227298,2469341,2797
A Most Violent Year,5749134,6257936,12007070,172788,4
Danny Collins,5637066,5198686,10835752,72459,5
Foxcatcher,12096300,7110213,19206513,270877,6
Bajirao Mastani,6557047,4793870,11350917,1744975,304
Room,14677654,20724104,35401758,118298,4
90 Minutes in Heaven,4842699,0,4842699,2035273,878
True Story,4719695,541900,5261595,1950214,831
Suffragette,4702420,27269676,31972096,76244,4
Top Five,25317471,800000,26117471,6896593,979
Baahubali: The Beginning,6738000,49855,6787855,3575000,236
The Danish Girl,11114018,53077505,64191523,187318,4
Hubble 3D,52522904,21726825,74249729,413477,39
Dilwale,4871263,27123060,31994323,1920402,268
Found a Treasure Called Love,4364639,48351132,52715771,2425585,287
The Water Diviner,4196641,33979676,38176317,1220335,320
Irrational Man,4030360,23360724,27391084,175312,7
Carol,12711491,27560644,40272135,253510,4
Scouts Guide to the Zombie Apocalypse,3703046,12434000,16137046,1841007,1509
A la mala,3629842,16785,3646627,1402118,384
Spare Parts,3618912,82369,3701281,1335768,440
We Are Your Friends,3591417,7530673,11122090,1767308,2333
What We Do in the Shadows,3469224,3477584,6946808,88940,5
Learning to Drive,3447633,2519883,5967516,66015,4
Mr. Turner,3958500,18221285,22179785,109000,5
Phoenix,3184472,2608773,5793245,30296,2
Dil Dhadakne Do,3066100,1095530,4161630,1326267,238
Ladrones,3063505,440909,3504414,1411031,375
Tanu Weds Manu Returns,3043479,1136602,4180081,1006476,136
Rock the Kasbah,3020664,373510,3394174,1470592,2012
The End of the Tour,3002884,70107,3072991,123238,4
Wild Tales,3106530,27536174,30642704,85100,4
Horrible Bosses 2,54445357,53200000,107645357,15457418,3375
He Named Me Malala,2668936,764670,3433606,61808,4
Captive,2583301,218207,2801508,1393243,806
Chi-Raq,2653032,66667,2719699,1198453,305
The Interview,6105175,5677450,11782625,1794666,331
Truth,2541854,2841243,5383097,66232,6
Mistress America,2500431,840306,3340737,93206,4
Pawn Sacrifice,2436633,3141886,5578519,202053,33
The Oscar Nominated Short Films 2015: Live Action,2412593,0,2412593,416850,118
Meru,2334228,0,2334228,91279,7
My All-American,2246000,0,2246000,1365000,1565
Ode To My Father,2300121,96785170,99085291,33880,1
Jem and the Holograms,2184640,149044,2333684,1375320,2413
Spectacle,2065487,13094275,15159762,1006059,182
Island of Lemurs: Madagascar,11272213,2794321,14066534,188307,37
Journey to the South Pacific,7653913,7340963,14994876,8137,1
Cake,1951776,408505,2360281,916179,482
PK,10616104,89754000,100370104,3565258,272
Old Fashioned,1914090,0,1914090,38965,3
Assassination,1904682,94215091,96119773,287700,33
Game of Thrones Season 4 Finale,1896092,0,1896092,1464932,205
Under the Sea 3D,36262926,19639698,55902624,661185,49
Legend,1872994,41100000,42972994,86836,4
Clouds of Sils Maria,1851517,2876884,4728401,61810,3
Testament of Youth,1822250,4052633,5874883,53000,4
Piku,1801807,650536,2452343,941490,119
The Vatican Tapes,1784763,11231001,13015764,832271,427
Jerusalem,8020721,1258735,9279456,0,0
Meet the Patels,1700681,0,1700681,72180,5
Patterns of Evidence: Exodus,925576,0,925576,764309,652
Back To The Future Day,1650000,12151197,13801197,0,0
The Letters,1647416,0,1647416,700683,886
Gone Girl,167767189,201563174,369330363,37513109,3014
The Diary of a Teenage Girl,1477002,298131,1775133,52334,4
I,1449232,1750881,3200113,771312,222
Infinitely Polar Bear,1430655,394023,1824678,47000,5
99 Homes,1411927,416305,1828232,32253,2
Welcome Back,1388365,20387329,21775694,714235,135
"Two Days, One Night",1436243,7580679,9016922,30700,2
The Cokeville Miracle,1348456,0,1348456,159468,51
"Alexander and the Terrible, Horrible, No Good, Very Bad Day",66954149,33700000,100654149,18360230,3088
Iris,1310678,310030,1620708,57254,6
Lost in Hong Kong,1302281,254981631,256283912,537736,28
The Wolfpack,1301696,112444,1414140,43920,2
Youth,2703296,20766244,23469540,78085,4
Goodbye Mr. Loser,1293626,226829302,228122928,363949,22
'71,1270847,1791331,3062178,55761,4
Dumb and Dumber To,86208010,83629000,169837010,36111775,3154
Beyond the Mask,1236094,0,1236094,18801,17
Child 44,1224330,11726763,12951093,621812,510
Veteran,1200627,93192393,94393020,371754,46
Goodnight Mommy,1178196,1015278,2193474,63641,4
Black Sea,1171559,2586544,3758103,37675,5
Miss You Already,1162653,6411344,7573997,552506,384
The Salt of the Earth,1343349,4068840,5412189,44900,4
Where Hope Grows,1156000,3072,1159072,457287,276
Boyhood,25352281,22785385,48137666,387618,5
The Overnight,1110522,0,1110522,53022,3
Timbuktu,1076075,6103316,7179391,45110,4
Leviathan,1092800,3346681,4439481,15200,2
Dior and I,1028953,740879,1769832,45772,2
5 Flights Up,1020921,2658926,3679847,238491,87
Big Stone Gap,1009301,3503,1012804,362422,280
Faith of Our Fathers,1004105,0,1004105,433000,344
Xun long jue,1243810,258124638,259368448,279974,22
St. Vincent,44137712,10699522,54837234,109878,4
Gett,988150,271010,1259160,24210,2
Space Station 3D,93383953,34979928,128363881,489488,24
The 100 Year-Old Man Who Climbed Out the Window and Disappeared,944193,50223379,51167572,0,0
Boruto: Naruto The Movie,919651,37442797,38362448,380419,140
Singh Is Bliing,919095,19305756,20224851,487040,135
Best of Enemies: Buckley vs. Vidal,892802,0,892802,50378,3
Any Body Can Dance 2,892133,284825,1176958,444195,146
The Revenant,183637894,349312609,532950503,474560,4
Macbeth,1110707,15211360,16322067,69833,5
The Book of Life,50151543,49632013,99783556,17005218,3071
Sleeping with Other People,819431,2405516,3224947,89102,5
Song of the Sea,857522,3333148,4190670,21910,2
The Wrecking Crew!,801606,0,801606,56858,7
Mr. Six,1415450,137775895,139191345,332117,30
Labyrinth of Lies,794452,3780304,4574756,22101,3
Seymour: An Introduction,743541,164201,907742,26587,2
Once I Was a Beehive,732655,0,732655,48409,19
Cartel Land,704352,441571,1145923,15581,2
Tangerine,702354,112514,814868,60683,4
Red Army,694600,104080,798680,20100,3
The D Train,673151,101629,774780,469000,1009
The Stanford Prison Experiment,660561,2553,663114,37514,2
The Assassin,632542,11359127,11991669,47892,4
Citizenfour,2800870,979822,3780692,126321,5
Brothers,613775,19080675,19694450,357404,164
Welcome to Me,608852,27967,636819,34920,2
"Kumiko, The Treasure Hunter",623383,116240,739623,34114,4
Born to Be Wild,25978556,15665919,41644475,871478,206
Detective Byomkesh Bakshy!,579055,248382,827437,338637,82
Fury,85817906,126000000,211817906,23702421,3173
Freeheld,573335,901136,1474471,37983,5
Awake: The Life of Yogananda,1539680,352238,1891918,18885,1
Jimmy's Hall,560592,4264592,4825184,19881,3
When Marnie Was There,561085,34388482,34949567,27388,2
A Little Chaos,558173,9526450,10084623,181791,83
Nightcrawler,32381217,15017775,47398992,10441000,2766
By the Sea,538460,2796467,3334927,96250,10
Gabbar is Back,534601,463981,998582,279429,107
The Last: Naruto the Movie,524451,2424734,2949185,179370,23
Shaandaar,521794,13599014,14120808,384685,136
The Black Panthers: Vanguard of the Revolution,516893,67216,584109,20215,1
Deli Man,502294,0,502294,37321,15
Remember,547009,2507927,3054936,27006,27
Steve Jobs: The Man in the Machine,494506,0,494506,140064,68
Phantom,489984,13186606,13676590,266756,93
Somewhere Only We Know,482341,45255370,45737711,304934,46
Brotherly Love,478595,0,478595,246902,200
About Elly,470760,0,470760,13180,1
Let's Get Married,462918,45509806,45972724,180929,39
Bombay Velvet,450692,307786,758478,390774,218
Attack on Titan Part 1,449523,30361135,30810658,23829,12
The Third Man,449191,29754,478945,24832,3
Felix and Meira,447353,49361,496714,15000,1
Rosenwald,433924,0,433924,7902,1
Listen to Me Marlon,425831,90506,516337,30068,2
A Matter of Faith,680113,0,680113,138677,25
The Witness,418063,33545494,33963557,194736,40
Unbranded,410185,2607,412792,141416,80
City of Revenge,409166,0,409166,227759,82
The Hunting Ground,405917,0,405917,22464,2
The Apu Trilogy,402723,0,402723,16064,1
Freetown,401328,0,401328,118553,124
She's Beautiful When She's Angry,421573,0,421573,10505,1
Peggy Guggenheim: Art Addict,498428,229163,727591,22258,2
Coming Home,377607,47210377,47587984,26361,3
The Second Mother,376986,2626574,3003560,24086,3
Katti Batti,364932,3714203,4079135,239816,127
Kahlil Gibran's The Prophet,370146,126768,496914,0,0
Kahlil Gibran's The Prophet,355343,409155,764498,27435,2
Effie Gray,352534,368609,721143,161728,201
Maps to the Stars,350741,4160193,4510934,143422,66
Noble,347321,860065,1207386,231319,175
Talvar,342370,6536728,6879098,144713,51
Saint Laurent,429477,2772764,3202241,36000,4
Northern Limit Line,337907,39696770,40034677,108255,13
A Girl Walks Home Alone at Night,491910,54442,546352,0,0
The Boxtrolls,50837305,57418465,108255770,17275239,3464
Ballet 422,333554,0,333554,27653,2
Shamitabh,324597,7224,331821,241720,137
The Maze Runner,102427862,245891999,348319861,32512804,3604
Good Kill,316472,1157999,1474471,17750,2
David and Goliath,316100,0,316100,154901,31
Heart of a Dog,420813,55571,476384,13893,1
The Babadook,964413,9348127,10312540,30007,3
Running Man,310978,68471497,68782475,186926,20
Attack on Titan Part 2,305934,14880476,15186410,12861,230
The Man in 3B,291513,0,291513,109043,36
Taxi,321642,3584585,3906227,22531,3
N.H 10,303587,0,303587,149546,40
Above and Beyond,288751,0,288751,6448,1
Go Away Mr. Tumor,286639,80320254,80606893,50036,15
White God,282358,299546,581904,16139,2
A Borrowed Identity,281540,649418,930958,10308,1
In the Name of My Daughter,277528,2260371,2537899,14294,3
Tevar,236002,6451,242453,171026,127
Force Majeure,1359497,2734842,4094339,23309,2
Love,249083,611974,861057,29301,2
Janis: Little Girl Blue,410465,1272701,1683166,21861,2
Guardians of the Galaxy,333176600,439600000,772776600,94320883,4080
Carter High,240214,0,240214,87274,21
Hamari Adhuri Kahani,235361,263413,498774,131263,67
Miss Granny,234573,59161738,59396311,92827,13
The Homesman,2429989,1389432,3819421,45433,4
Slow West,229094,1066480,1295574,67003,50
The Taking of Tiger Mountain,228984,141425071,141654055,50621,7
A Royal Night Out,228136,4551034,4779170,100847,158
The Grand Budapest Hotel,59301324,113635617,172936941,811166,4
A Pigeon Sat on a Branch Reflecting on Existence,222989,1249442,1472431,25313,2
Pyaar Ka Punchnama 2,222856,12760865,12983721,107536,49
John Wick,43037835,42975221,86013056,14415922,2589
Human Capital,158549,8955392,9113941,21669,6
The Equalizer,101530738,90800000,192330738,34137828,3236
Chocolate City,212662,0,212662,98829,15
Fall in Love Like a Star,212508,41277,253785,120074,36
Goodbye to Language,401889,164534,566423,0,0
Dark Places,208588,4882264,5090852,0,0
Heneral Luna,206040,4419599,4625639,15485,3
To the Arctic 3D,14560838,9134550,23695388,270228,50
Hitchcock/Truffaut,260430,126041,386471,28178,3
Escobar: Paradise Lost,195792,5356704,5552496,106869,105
Mommy,3494070,9662786,13156856,473882,62
Merchants of Doubt,308156,0,308156,20300,4
Gemma Bovery,191533,4452992,4644525,19095,5
The Connection,190980,11871461,12062441,10335,2
Lost and Love,188817,34741360,34930177,86048,24
Stonewall,187674,104995,292669,112834,129
Maggie,187112,1206940,1394052,131175,79
Detective K: Secret of the Lost Island,185367,27202503,27387870,57663,19
The Priests,185093,36392041,36577134,0,0
An Honest Liar,180590,0,180590,13821,2
Lambert & Stamp,183320,0,183320,13500,3
Walking With The Enemy,1112592,0,1112592,331855,258
Serena,176391,4915738,5092129,100090,59
The Young and Prodigious T.S. Spivet,173564,9321225,9494789,33658,100
The Farewell Party,172860,778671,951531,7616,2
All Things Must Pass,172394,0,172394,19001,2
A Brilliant Young Mind,171793,871827,1043620,31408,3
Time Out of Mind,166775,147307,314082,18934,3
Zhongkui: Snow Girl and the Dark Crystal,165428,64160519,64325947,73817,24
C'est Si Bon,164167,11585868,11750035,0,0
Sheng zhe wei wang,163406,6150421,6313827,73344,17
After the Ball,161820,72597,234417,31718,41
Mustang,845464,4429200,5274664,20321,3
3 Hearts,161129,2916625,3077754,11794,1
Theeb,283024,485425,768449,9181,3
Hell and Back,157768,0,157768,104374,411
Experimenter,155575,68570,224145,8682,3
Desert Dancer,155271,282894,438165,40763,23
"Good Day, Ramon",154356,4950512,5104868,51105,15
Backstreet Boys: Show 'Em What You're Made Of,153068,0,153068,153068,60
Samba,151530,39027165,39178695,24588,2
The Tribe,150564,64470,215034,11094,1
Forever Young,149761,59832141,59981902,70047,14
The New Girlfriend,146754,5069042,5215796,39035,13
The Last Five Years,145427,146665,292092,42042,3
Tangerines,144501,879631,1024132,5180,1
45 Years,4247285,10182964,14430249,65775,3
5 to 7,162685,511894,674579,18006,2
Twenty,136125,22135737,22271862,0,0
La Sapienza,135392,0,135392,0,0
Cop Car,134552,9106,143658,26146,3
Don't Think I've Forgotten: Cambodia's Lost Rock and Roll,133443,0,133443,19206,3
Manglehorn,143101,316535,459636,11227,3
A Ballerina's Tale,131995,0,131995,9388,2
Mississippi Grind,130541,292205,422746,12434,1
Kung Fu Jungle,129784,23940981,24070765,58664,28
A Journey Through Time with Antony,127381,6262267,6389648,55292,17
Boulevard,126150,114300,240450,7000,1
Son of Saul,1777043,4882078,6659121,37930,3
The Tale of The Princess Kaguya,703232,23663424,24366656,54915,3
Z for Zachariah,121461,260378,381839,56902,29
Ida,3827060,7329776,11156836,55438,3
Digging for Fire,119364,0,119364,25000,3
The Judge,47119388,37300000,84419388,13116226,3003
Love Live! The School Idol Movie,115840,21176169,21292009,115840,28
Road Hard,113169,0,113169,105943,22
She's Funny That Way,111996,5922855,6034851,0,0
Memories of the Sword,111071,2233991,2345062,50240,22
Roar,110048,0,110048,15064,5
The Look of Silence,109089,48768,157857,6616,1
Adult Beginners,108808,0,108808,36657,10
The Beauty Inside,108083,14193786,14301869,50536,23
I Am Eleven,310116,0,310116,5800,2
The Himalayas,696717,49847776,50544493,13387,3
Chronicles of Evil,105057,15355437,15460494,0,0
Results,104507,0,104507,17782,3
Every Secret Thing,103536,21197,124733,97020,20
In Jackson Heights,121094,0,121094,15150,1
A Lego Brickumentary,101531,0,101531,43285,93
Man from Reno,101438,0,101438,15158,4
James White,101368,0,101368,12007,1
Ghost in the Shell: The New Movie,101203,1231108,1332311,0,0
Black Souls,101088,1177272,1278360,6286,2
1915,111682,0,111682,30448,8
A Poem Is a Naked Person,96592,0,96592,5526,1
Saving Mr. Wu,92696,31129465,31222161,0,0
The Tales of Hoffmann,91930,14930,106860,23340,2
Christmas Eve,91302,73537,164839,45260,44
Queen of Earth,91218,3965,95183,11360,2
Legends from the Sky,91462,0,91462,18168,8
Beasts of No Nation,90777,0,90777,51003,31
Hero,88675,45476859,45565534,58445,53
Sunshine Superman,88097,8618,96715,8991,3
Beyond the Lights,14618727,0,14618727,6200284,1789
Trace Amounts,80735,0,80735,0,0
Heaven Knows What,80734,3683,84417,16862,2
Do I Sound Gay?,119388,3207,122595,10461,1
Nasty Baby,79800,972,80772,8023,2
Tab Hunter Confidential,85812,0,85812,9945,2
Antarctica: A Year on Ice,288757,0,288757,32238,8
Blackbird,78400,0,78400,45834,13
Wei ai zhi jian ru jia jing,271734,45114826,45386560,67967,17
Anomalisa,3759286,1900000,5659286,135222,4
Batkid Begins: The Wish Heard Around the World,74709,0,74709,19437,4
Six Dance Lessons in Six Weeks,106323,0,106323,12542,7
Dragon Blade,74068,122519781,122593849,30346,14
The Principle,89543,0,89543,8657,1
Freaks of Nature,70958,0,70958,42713,107
The Wonders,73378,2698980,2772358,0,0
Predestination,68372,4756127,4824499,44028,20
National Gallery,253941,101030,354971,10049,1
I Am Big Bird: The Caroll Spinney Story,67845,0,67845,10000,1
Turbo Kid,67069,0,67069,31428,26
People Places Things,67046,110292,177338,31262,19
Eden,65460,429489,494949,18987,3
The Office,63675,8226846,8290521,34144,15
The Pyramid,2756333,14104804,16861137,1369935,589
Drunk Stoned Brilliant Dead,62660,0,62660,5254,1
The Best of Me,26766213,11843455,38609668,10003827,2936
Only You,61565,10796324,10857889,27311,13
Dark Star: HR Gigers Welt,61845,0,61845,8349,5
Girlhood,60765,1802225,1862990,7667,2
Jauja,60231,56886,117117,8314,2
Gueros,60114,26622,86736,0,0
Cooties,60058,425486,485544,33031,29
I Smile Back,58738,4635,63373,15758,2
Rififi,57749,0,57749,17396,2
The Duke of Burgundy,64521,120626,185147,11902,3
The Search for General Tso,54275,0,54275,9336,2
The Ark of Mr Chow,54075,7840000,7894075,22583,12
Beloved Sisters,54030,2353650,2407680,19704,9
Aloft,53086,217885,270971,2116,2
Quay,51858,0,51858,16995,1
Deep Sea,46412757,51818148,98230905,700213,43
We Come as Friends,50921,23712,74633,0,0
Flowers,61568,77853,139421,6572,1
The Yes Men Are Revolting,50190,1141,51331,12462,10
The Advocate: A Missing Body,50162,7500015,7550177,19770,9
Heist,50136,3244181,3294317,28688,24
Spring,49970,0,49970,19675,12
Difret,49667,47538,97205,6777,1
Red Herring,49480,0,49480,27804,28
The Seven Five,48869,0,48869,14785,2
Bangistan,48694,761725,810419,34263,41
The Lady in the Van,10021175,31366512,41387687,0,(
Appropriate Behavior,46912,76787,123699,19114,11
Zero Motivation,116044,22565,138609,9427,1
Shanghai,46425,0,46425,26604,103
Beyond the Reach,45895,1054537,1100432,30287,27
Lost River,45431,570069,615500,20828,3
Mr. X,44995,5016392,5061387,30097,52
The Salvation,44903,1319061,1363964,4651,2
Madame Bovary,44235,614297,658532,20841,15
Charlie's Country,42937,160029,202966,5340,4
Ingrid Bergman: In Her Own Words,138148,75866,214014,8355,1
Breathe,42297,1116398,1158695,5063,1
Nowitzki: The Perfect Shot,41340,578177,619517,20049,4
Queen & Country,41297,114584,155881,5954,1
The New Rijksmuseum - The Film,40578,35882,76460,2631,3
The Phone,40516,10510802,10551318,3824,1
What Our Fathers Did: A Nazi Legacy,40119,14484,54603,8132,2
Entertainment,55506,0,55506,5132,2
WARx2,2310625,0,2310625,30931,1
Prophet's Prey,39347,0,39347,5000,1
Lila & Eve,38263,141544,179807,21806,22
Match,37285,0,37285,6000,3
Before We Go,37151,425724,462875,18630,21
The Mafia Kills Only in Summer,37134,376102,413236,0,0
Grey Gardens,36923,0,36923,13845,1
Sister Code,36676,0,36676,25388,37
Knock Knock,36336,5530767,5567103,18623,22
The Kindergarten Teacher,36190,247875,284065,0,0
Welcome to Leith,36010,370,36380,3707,1
Finders Keepers,35555,0,35555,5740,5
The Pearl Button,42166,77587,119753,0,0
Wild City,34866,24782986,24817852,17181,11
Dear White People,4404154,229807,4633961,347959,11
Song One,32251,376667,408918,20200,27
Love Forecast,32211,13576426,13608637,11600,1
Amira & Sam,31849,0,31849,15535,9
The Forbidden Room,34404,13678,48082,0,0
Out 1,31539,6204,37743,12537,4
Don Verdean,31309,0,31309,12907,40
"3 1/2 Minutes, 10 Bullets",30407,8856,39263,2238,1
Yellow Day,144163,0,144163,26260,2
Army of Shadows,30190,0,30190,8112,1
Runoff,30186,0,30186,9515,1
Paul Taylor: Creative Domain,30168,0,30168,8150,1
Paulette,29494,34631,64125,8882,1
Rebels of the Neon God,28791,0,28791,0,0
Americons,28782,0,28782,14404,14
Hard to Be a God,28608,1270427,1299035,0,0
Meet the Mormons,6047363,0,6047363,2509808,317
The Nightmare,28281,13572,41853,13363,16
Censored Voices,41260,0,41260,6153,2
"Like Sunday, Like Rain",28208,0,28208,1082,2
7 Chinese Brothers,28180,0,28180,0,0
The Cut,28066,1204074,1232140,5327,5
Sagrada: The Mystery of Creation,58755,0,58755,2009,1
The Keeping Room,27166,46756,73922,4328,2
Tap World,26747,0,26747,8714,3
Last Days in Vietnam,466114,0,466114,30500,2
Love at First Fight,25229,2421133,2446362,3187,2
R100,24956,0,24956,7263,10
Big Game,24752,7430646,7455398,16909,11
Olvidados,24638,0,24638,2791,1
Kill Me Three Times,24296,77511,101807,15477,16
Can't Stand Losing You: Surviving the Police,23262,0,23262,5656,2
Hippocrates: Diary of a French Doctor,23050,7532541,7555591,0,0
Court,22898,34518,57416,4806,1
Salut d'Amour,22480,7835703,7858183,6514,1
Metropolitan,22284,0,22284,7554,1
Slow Learners,22272,0,22272,948,1
Princess Cut,22167,0,22167,0,0
Mediterranea,22076,24316,46392,5846,2
Animals,21821,0,21821,14471,10
Fleet of Time,569280,93674911,94244191,206591,20
Boy Meets Girl,20441,0,20441,5306,1
"Love, Rosie",20431,25553956,25574387,14893,15
Futuro Beach,20262,759573,779835,3324,1
Friends and Romans,20136,0,20136,0,0
The Good Lie,2722209,674136,3396345,841422,461
Peace Officer,26632,0,26632,0,0
Forbidden Games,19889,0,19889,4316,1
My Old Lady,4013786,6592881,10606667,124680,11
Misery Loves Comedy,19634,0,19634,5300,1
Going Away,19501,2271388,2290889,7714,1
Monk with a Camera,45938,0,45938,0,0
The Challenger,19003,0,19003,12246,28
Little Accidents,10071,0,10071,8649,17
Ardor,18565,76984,95549,13726,17
The Little Death,18238,582924,601162,3118,2
Gangnam 1970,18022,16173412,16191434,18022,1
The Great Museum,18020,115885,133905,0,0
The Other One,17727,0,17727,11718,6
The Boy and the World,129480,25735,155215,10077,2
Trash,17484,4791538,4809022,10230,17
Strangerland,17472,93635,111107,17472,15
Love Thy Nature,41149,11798,52947,0,0
Eastern Boys,16831,147459,164290,5726,1
Extraction,16775,693861,710636,10948,13
Eva,16738,0,16738,10395,50
This Changes Everything,16692,0,16692,9770,1
Who Took Johnny,16595,0,16595,7666,1
Long Live Freedom,48541,947449,995990,5272,2
The Human Centipede III (Final Sequence),16184,0,16184,0,0
Pierrot le Fou,34371,0,34371,7922,1
Can You Dig This,15909,0,15909,0,0
Full Moon in Paris,15726,0,15726,5040,1
Number One Fan,15549,3635049,3650598,1023,1
Cheatin',15077,0,15077,0,0
Zombeavers,14947,40038,54985,8163,11
Gloria,14701,0,14701,7930,3
10 Days in a Madhouse,14616,0,14616,4773,1
Buzzard,14591,0,14591,8031,11
River of Fundament,44840,0,44840,9938,1
The Hallow,13906,1848501,1862407,1559,1
Blackfoot Trail,13848,0,13848,1005,1
Goodbye to All That,16986,0,16986,0,0
Noma: My Perfect Storm,21130,47492,68622,2987,4
Amour Fou,13702,47991,61693,4385,3
Eli,13547,0,13547,7098,18
The Passionate Thief,31539,0,31539,8677,1
The World of Kanako,16627,0,16627,6834,11
10.000 Km,12423,210107,222530,8941,11
The Overnighters,110763,0,110763,4324,1
The Armor of Light,12267,0,12267,0,0
Wa-shoku Dream: Beyond Sushi,12240,0,12240,5582,1
A Murder in the Park,12088,0,12088,1310,1
Little England,12077,0,12077,5775,1
Diplomacy,230880,3976362,4207242,8518,1
Of Horses and Men,11894,228075,239969,9565,1
Emptying the Skies,11811,0,11811,4818,2
Marie's Story,11720,337186,348906,0,0
Listen Up Philip,200126,0,200126,23284,2
Kidnapping of Michel Houellebecq,11546,96095,107641,0,0
Consumed,20476,0,20476,0,0
A Tale of Winter,23268,29163,52431,3802,1
Walking the Camino: Six Ways to Santiago,612717,0,612717,0,0
The Devil's Violinist,11294,3940803,3952097,8013,10
Actress,19365,0,19365,4880,1
Just Before I Go,10970,0,10970,8129,2
Digging Up the Marrow,10969,0,10969,0,0
Wolf Totem,210591,125626479,125837070,0,0
Sembene!,28059,0,28059,0,0
Mala Mala,10761,0,10761,2569,2
Gabo: The Creation of Gabriel Garcia Marquez,19337,0,19337,1432,1
Dark Horse,90136,0,90136,1865,1
Empire of Lust,10654,3180514,3191168,2230,1
"One Cut, One Life",9406,0,9406,4127,2
The Forecaster,10172,652,10824,0,0
The Life and Mind of Mark DeFriest,10021,0,10021,0,0
Our Little Sister,64441,15343174,15407615,0,0
Wild Canaries,19777,0,19777,2683,1
Why Don't You Play in Hell?,28534,1237338,1265872,5060,3
Still Life,9481,2485544,2495025,0,0
Every Thing Will Be Fine,9233,545720,554953,1428,2
Cupcakes,9129,0,9129,2570,1
"Arabian Nights - Volume 1, The Restless One",12260,15985,28245,0,0
The Lesson,9045,56097,65142,0,0
Butterfly Girl,17503,0,17503,4326,2
Northern Soul,8886,1083473,1092359,6786,10
B-Side,8870,0,8870,6544,3
The Pardon,8845,0,8845,1418,1
Paulo Coelho's Best Story,8808,608569,617377,5295,5
Dawn of the Crescent Moon,8799,0,8799,6411,3
Meet Me in Montenegro,8612,0,8612,5010,10
Hiroshima Mon Amour,96439,0,96439,18494,5
Farewell to Hollywood,8601,0,8601,572,1
Art and Craft,235037,0,235037,20879,2
Counting,8374,0,8374,4904,1
Advanced Style,87879,119352,207231,6500,1
The Girl in the Book,8245,73134,81379,5249,10
A Fool,8212,2059608,2067820,5741,2
Jellyfish Eyes,8176,0,8176,1927,1
Straight Outta Tompkins,8022,0,8022,4011,2
One Small Hitch,7965,0,7965,5328,10
Kilo Two Bravo,7891,26126,34017,0,0
A Hard Day,19004,26469843,26488847,0,0
The Great Man,7814,0,7814,2482,1
Area 51,7556,0,7556,7556,16
The Winding Stream,33420,0,33420,3660,3
On the Way to School,7424,533234,540658,0,0
Rubble Kings,7416,0,7416,0,0
The Film Critic,7358,158533,165891,839,2
The Dinner,7282,937526,944808,805,1
Set Fire to the Stars,4280,0,4280,1132,1
Dreams Rewired,11843,3783,15626,0,0
Antarctic Edge: 70° South,7193,0,7193,3131,1
Li'l Quinquin,7192,10676,17868,3204,1
"If You Don't, I Will",9719,0,9719,1707,1
Gabriel,6959,0,6959,2124,1
Hungry Hearts,6921,527628,534549,1869,2
The Sisterhood of Night,6870,0,6870,5264,10
Steve McQueen: The Man & Le Mans,6843,34360,41203,4079,2
Women Who Flirt,375495,38780637,39156132,74052,26
Capture the Flag,6690,24597641,24604331,6690,20
Horse Money,6508,0,6508,3409,1
The Suicide Theory,6434,0,6434,5229,10
Alleluia,6334,42092,48426,2712,3
The Night of the Shooting Stars,6186,0,6186,4414,1
Barely Lethal,6075,927772,933847,0,0
The Marquise of O,6048,0,6048,0,0
The Riot Club,7734,3510191,3517925,2188,1
"Sex, Death and Bowling",5972,0,5972,50,1
Medeas,5895,0,5895,3025,1
Top Spin,5858,0,5858,2177,1
Shout Gladi Gladi,5839,0,5839,5046,2
The Wanted 18,5680,0,5680,0,0
Tu Dors Nicole,5662,783,6445,0,0
This Isn't Funny,5654,0,5654,690,1
Gone Doggy Gone,14354,0,14354,5625,2
Inside the Mind of Leonardo,10600,0,10600,0,0
Chic!,5587,289708,295295,587,1
Our Man in Tehran,5573,0,5573,1640,1
The Living,5514,0,5514,74,1
The Way He Looks,101451,1106390,1207841,26334,9
Concerning Violence,12680,0,12680,0,0
Revenge of the Mekons,11861,0,11861,2354,1
Far from Men,5336,1005149,1010485,0,0
She's Lost Control,5319,0,5319,900,1
Sarajevo,5247,0,5247,5247,1
The Dead Lands,5240,900918,906158,1327,3
The Princess of France,5212,0,5212,0,0
Death Valley,5211,0,5211,4344,2
A Reason,15792,0,15792,1690,3
SBK: The Movie,4950,0,4950,2650,6
Gerontophilia,4916,4158,9074,1927,1
Guidance,4900,0,4900,0,0
"Arabian Nights - Volume 2, The Desolate One",6398,8847,15245,0,0
Miss Hill: Making Dance Matter,4706,0,4706,2560,1
Jenny's Wedding,4704,38223,42927,2254,2
Against the Sun,4646,0,4646,3023,11
Ashby,4631,118288,122919,4631,15
Seeds of Time,4630,0,4630,0,0
"Farewell, Herr Schwarz",4445,0,4445,0,0
Club Life,4444,214785,219229,0,0
The Sacrifice,20945,0,20945,0,0
Back to the Jurassic,4351,65072,69423,0,0
Days of Grace,4308,0,4308,2213,1
The Knife of Don Juan,4254,0,4254,2330,2
The Worst Movie Ever!,25206,0,25206,11,1
Three Night Stand,4076,0,4076,2538,10
Salvation Army,3929,48582,52511,2433,1
Unfreedom,3778,0,3778,0,0
The Free Speech Apocalypse,3726,0,3726,1320,1
In the Basement,3643,182393,186036,748,1
Fidelio: Alice's Odyssey,3580,16991,20571,454,1
"Arabian Nights - Volume 3, The Enchanted One",4502,2179,6681,0,0
Mahogany Sunrise,3432,0,3432,0,0
Hyena,3401,185,3586,0,0
The Iron Ministry,3340,545,3885,896,3
Mi America,3330,0,3330,3330,1
Know How,3323,0,3323,2414,2
Tip Top,6050,4151,10201,0,0
Drunk Wedding,3301,0,3301,3301,16
Windsor Drive,3256,0,3256,2160,2
Blackhats,3216,0,3216,2482,1
The Immortalists,9331,0,9331,0,0
Rosewater,3128941,42652,3171593,1154303,371
Xenia,3181,26093,29274,358,1
Le Jour Se Leve,35321,0,35321,11864,3
T-Rex: Back to the Cretaceous,53354743,50605624,103960367,0,0
Julia,2710,0,2710,2110,5
Chocolat,2710,0,2710,2710,1
On War,5086,0,5086,2210,1
Body,2634,0,2634,2457,1
Hayride 2,2571,0,2571,1668,10
Moana,2993,0,2993,2274,1
"20,000 Days on Earth",279558,1826000,2105558,27879,1
L.A. Slasher,2421,0,2421,2421,7
The King and the Mockingbird,27513,0,27513,3721,1
Nostalgia for the Light,163962,13672,177634,5664,1
Life of Riley,11616,2411763,2423379,0,0
Anita Ho,2250,0,2250,2250,1
Life Partners,8265,0,8265,2665,3
Me You and Five Bucks,2105,0,2105,862,2
Steak (R)evolution,8025,13,8038,0,0
Gringo Trails,8349,0,8349,158,1
Penton: The John Penton Story,112159,0,112159,0,0
Manuscripts Don't Burn,6295,0,6295,0,0
Magnificent Desolation: Walking on the Moon 3D,34137524,6201878,40339402,479587,80
Sneakerheadz,1903,0,1903,1903,3
The Captive,1075178,1015434,2090612,407804,132
The Other Man: F.W. de Klerk and the End of Apartheid,1747,0,1747,1153,1
The Lady in the Car with Glasses and a Gun,2167,337294,339461,297,2
Dark Forest,1739,0,1739,1739,1
The Looking Glass,1711,0,1711,107,2
1001 Grams,10983,170047,181030,0,0
Level Five,27000,0,27000,7161,2
Drown,1631,0,1631,860,1
Cut Snake,1625,0,1625,0,0
Forever,1598,0,1598,0,0
An Eye for Beauty,9395,36118,45513,0,0
Stations of the Cross,1505,73004,74509,688,1
Making Rounds,1484,0,1484,1056,1
Beyond the Farthest Star,31433,0,31433,0,0
Flamenco Flamenco,71732,0,71732,1259,1
Along the Roadside,1352,0,1352,965,0
Faith Connections,9111,0,9111,0,0
3 Nights in the Desert,1297,0,1297,234,2
Skin Trade,1242,594026,595268,162,1
El nino,1237,20917739,20918976,245,1
The Summer of Sangaile,4480,49363,53843,453,1
The Decent One,21327,13955,35282,0,0
Childless,1036,0,1036,732,1
Through a Lens Darkly: Black Photographers and the Emergence of a People,65169,0,65169,9456,1
Life in a Walk,16557,0,16557,0,0
They Are We,900,0,900,590,1
Le talent de mes amis,889,375633,376522,587,1
Half of a Yellow Sun,54529,251864,306393,4843,1
Big Muddy,881,0,881,147,2
[REC] 4: Apocalypse,837,4914920,4915757,708,5
Stray Dogs,10433,3140,13573,2998,1
Rediscover Sautet,25314,0,25314,0,0
The Lovely Month of May,55038,0,55038,10662,3
Rakuen Tsuiho: Expelled from Paradise,34510,0,34510,18869,13
Two-Bit Waltz,2540,0,2540,136,1
It's All So Quiet,724,0,724,362,1
It's Hard Being Loved by Jerks,697,0,697,0,0
Justice Is Mind,14360,0,14360,5418,1
Glen Campbell: I'll Be Me,365422,0,365422,86741,10
On Tour with Pina Bausch,18016,0,18016,1756,1
United Passions,607,170904,171511,607,10
Finding Fela,120980,31366,152346,0,0
K2: Siren of the Himalayas,12959,0,12959,1421,2
Far from Vietnam,8132,0,8132,1125,1
Elsa & Fred,285863,350038,635901,65275,34
The Chambermaid Lynn,315,71603,71918,0,0
Sol LeWitt,13146,0,13146,4051,1
Lou!,287,1580838,1581125,88,1
Pioneer,6871,2640949,2647820,1857,2
Uzumasa Limelight,19597,0,19597,10090,13
The Golden Era,102931,25995,128926,50242,15
Yakuza Apocalypse,12756,0,12756,0,0
Exhibition,14344,34,14378,0,0
Paranoid Girls,78,0,78,54,1
Confession of a Child of the Century,74,0,74,68,1
Memphis,21286,0,21286,0,0
"Je t'aime, je t'aime",71717,0,71717,12869,1
Finding Dory,486295561,542275328,1028570889,135060273,4305
Rogue One: A Star Wars Story,532177324,523879949,1056057273,155081681,4157
Captain America: Civil War,408084349,745211944,1153296293,179139142,4226
The Secret Life of Pets,368384330,507073607,875457937,104352905,4370
The Jungle Book,364001123,602549477,966550600,103261464,4028
Deadpool,363070709,419541446,782612155,132434639,3558
Zootopia,341268248,682515947,1023784195,75063401,3827
Batman v Superman: Dawn of Justice,330360194,543274725,873634919,166007347,4242
Suicide Squad,325100054,421746840,746846894,133682248,4255
Star Wars: Episode VII - The Force Awakens,936662225,1131561399,2068223624,247966675,4134
Doctor Strange,232641920,445076475,677718395,85058311,3882
Fantastic Beasts and Where to Find Them,234037575,580000000,814037575,74403387,4144
Moana,248757044,394574067,643331111,56631401,3875
The Revenant,183637894,349312609,532950503,474560,4
Jason Bourne,162434410,253050504,415484914,59215365,4026
Star Trek Beyond,158848340,184623476,343471816,59253211,3928
X-Men: Apocalypse,155442489,388491616,543934105,65769562,4150
Sing,270395425,363756254,634151679,35258145,4022
Trolls,153707064,193157398,346864462,46581142,4060
Kung Fu Panda 3,143528619,377642206,521170825,41282042,3955
Ghostbusters,128350574,100796935,229147509,46018755,3963
Central Intelligence,127440871,89531672,216972543,35535250,3508
The Legend of Tarzan,126643061,230057296,356700357,38527856,3561
Sully,125070033,115727590,240797623,35028301,3525
Bad Moms,113257297,70678777,183936074,23817340,3215
The Angry Birds Movie,107509366,244824563,352333929,38155177,3932
Independence Day: Resurgence,103144286,286537649,389681935,41039944,4130
The Conjuring 2,102470008,217922810,320392818,40406314,3343
Sausage Party,97685686,43019636,140705322,34263534,3103
The Magnificent Seven,93432655,68927981,162360636,34703397,3674
Arrival,100546139,102842047,203388186,24074047,2317
Ride Along 2,91221830,33383467,124605297,35243095,3175
Don't Breathe,89217875,68612612,157830487,26411706,3051
Miss Peregrine's Home for Peculiar Children,87242834,209239612,296482446,28871140,3522
The Accountant,86260045,68900000,155160045,24710273,3332
Daddy's Home,150357137,92429000,242786137,38740203,3271
Teenage Mutant Ninja Turtles: Out of the Shadows,82051601,163572247,245623848,35316382,4071
The Purge: Election Year,79213375,39374505,118587880,31515110,2796
Alice Through the Looking Glass,77041381,222415643,299457024,26858726,3763
Pete's Dragon,76233151,67462187,143695338,21514095,3702
The Girl on the Train,75395035,97790824,173185859,24536265,3144
Tyler Perry's Boo! A Madea Halloween,73206343,1621001,74827344,28501448,2260
Storks,72679278,110709675,183388953,21311407,3922
10 Cloverfield Lane,72082998,38134000,110216998,24727437,3391
Lights Out,67268835,81600000,148868835,21688103,2818
Allegiant,66184051,113062817,179246868,29027348,3740
Now You See Me 2,65075540,269822066,334897606,22383146,3232
Hacksaw Ridge,67209615,113241303,180450918,15190758,2886
Ice Age: Collision Course,64063008,344516030,408579038,21373064,3992
The Boss,63285885,15558697,78844582,23586645,3480
London Has Fallen,62524260,143230187,205754447,21635601,3490
Miracles from Heaven,61705123,12277880,73983003,14812393,3047
Deepwater Horizon,61433527,60356846,121790373,20223544,3259
My Big Fat Greek Wedding 2,59689605,30943036,90632641,17861950,3133
Jack Reacher: Never Go Back,58697076,103449000,162146076,22872490,3780
Me Before You,56245075,152069111,208314186,18723269,2704
The BFG,55483770,139759641,195243411,18775350,3357
Neighbors 2: Sorority Rising,55455765,52551344,108007109,21760405,3384
Passengers,100014699,203129453,303144152,14869736,3478
The Shallows,55124043,63976715,119100758,16800868,2962
Barbershop: The Next Cut,54030051,1000000,55030051,20242415,2661
13 Hours,52853219,16558151,69411370,16194738,2389
Office Christmas Party,54767494,59733805,114501299,16890204,3210
The Huntsman: Winter's War,48390190,116599148,164989338,19445035,3791
Kubo and the Two Strings,48023088,28226350,76249438,12608372,3260
Warcraft,47365290,391683624,439048914,24166110,3400
How to Be Single,46843513,65500000,112343513,17878911,3343
The Big Short,70259870,63181000,133440870,705527,8
Mike and Dave Need Wedding Dates,46009673,31058573,77068246,16628170,2982
War Dogs,43034523,43200000,86234523,14685305,3258
Almost Christmas,42158780,422140,42580920,15134235,2376
Money Monster,41012075,52270529,93282604,14788157,3104
The Hateful Eight,54117416,101642701,155760117,4610676,100
Allied,40098064,79421959,119520023,12701743,3160
Nerve,38583626,46667799,85251425,9445456,2538
Sisters,87044645,17966408,105011053,13922855,2962
Risen,36880033,9552546,46432579,11801271,2915
Assassin's Creed,54647948,186049908,240697856,10278225,2970
The Nice Guys,36261763,26526455,62788218,11203270,2865
The Boy,35819556,28368811,64188367,10778392,2671
Dirty Grandpa,35593113,58479915,94073028,11111875,2912
Ouija: Origin of Evil,35144505,46561241,81705746,14065500,3167
The 5th Wave,34916787,74989585,109906372,10326356,2908
Inferno,34343574,185677685,220021259,14860425,3576
Mother's Day,32492859,16289811,48782670,8369184,3035
Gods of Egypt,31153464,119527400,150680864,14123903,3117
La La Land,151101803,295384421,446486224,881104,5
Why Him?,60323786,57778939,118102725,11002986,2917
"Hail, Caesar!",30498085,33149571,63647656,11355225,2232
Alvin and the Chipmunks: The Road Chip,85886987,148911649,234798636,14287159,3653
When the Bough Breaks,29747603,910784,30658387,14202323,2246
Zoolander 2,28848693,27874000,56722693,13841146,3394
Joy,56451232,44682827,101134059,17015168,2896
The Finest Hours,27569558,24529532,52099090,10288932,3143
Florence Foster Jenkins,27383770,21519183,48902953,6601313,1528
Manchester by the Sea,47695371,31292777,78988148,256498,4
Hell or High Water,27007844,10872033,37879877,621329,32
The Forest,26594261,13117739,39712000,12741176,2451
Ben-Hur,26410477,67650834,94061311,11203815,3084
Fences,57682904,6731857,64414761,129462,4
The Witch,25138705,15285240,40423945,8800230,2046
Collateral Beauty,31016021,57512259,88528280,7102085,3028
Bridget Jones's Baby,24252420,187700000,211952420,8571785,2927
What Now?,23591043,0,23591043,11767210,2567
Whiskey Tango Foxtrot,23083334,1888805,24972139,7450275,2374
Snowden,21587519,15769697,37357216,8000058,2443
Mechanic: Resurrection,21218403,104511232,125729635,7456525,2258
Free State of Jones,20810036,4225914,25035950,7572206,2815
Blair Witch,20777061,24396093,45173154,9576057,3121
God's Not Dead 2,20774575,3713273,24487848,7623662,2419
Keanu,20591853,59480,20651333,9453224,2658
Middle School: The Worst Years of My Life,20007149,3308990,23316139,6878437,2822
Nine Lives,19700032,38114413,57814445,6249915,2264
Race,19206207,5864054,25070261,7353922,2369
Spotlight,45055776,53634478,98690254,295009,5
Brooklyn,38322743,23753398,62076141,187281,5
The Choice,18730891,4333124,23064015,6050443,2631
Eye in the Sky,18704595,16555058,35259653,113803,5
Bad Santa 2,17782178,6297090,24079268,6176680,2920
Masterminds,17368022,12306677,29674699,6541205,3042
Concussion,34542474,14081098,48623572,10513749,2841
Norm of the North,17062499,13672003,30734502,6844137,2411
The Birth of a Nation,15861566,917646,16779212,7004254,2105
Eddie the Eagle,15789389,30363411,46152800,6084682,2042
The Infiltrator,15436808,5574302,21011110,5303775,1601
Keeping Up with the Joneses,14904426,15014319,29918745,5461475,3022
Criminal,14708696,24095297,38803993,5767278,2683
"Hello, My Name Is Doris",14444999,214449,14659448,84986,4
The Edge of Seventeen,14431633,4938387,19370020,4754215,1945
Love & Friendship,14016568,7385381,21401949,133513,4
Point Break,28782481,104936230,133718711,9800252,2910
Hillary's America: The Secret History of the Democratic Party,13099931,0,13099931,74814,3
Triple 9,12639297,10538651,23177948,6109085,2205
The Light Between Oceans,12545979,13429642,25975621,4765838,1500
Moonlight,27854932,37481671,65336603,402075,4
The Good Dinosaur,123087120,209120551,332207671,39155217,3749
The Hunger Games: Mockingjay - Part 2,281723902,376620235,658344137,102665981,4175
Fifty Shades of Black,11686940,10540574,22227514,5900528,2075
No manches Frida,11528613,12012324,23540937,3676235,362
Café Society,11103205,32660042,43763247,359289,5
Pride and Prejudice and Zombies,10938134,5519360,16457494,5324240,2931
The Darkness,10753574,144719,10898293,4950859,1755
Creed,109767581,63800000,173567581,29632823,3404
Nocturnal Animals,10663357,19648500,30311857,492648,37
The Lady in the Van,10021175,31366512,41387687,0,(
Room,14677654,20724104,35401758,118298,4
The Perfect Match,9669521,745217,10414738,4294232,925
Popstar: Never Stop Never Stopping,9639125,40904,9680029,4698715,2311
Hardcore Henry,9252038,7558524,16810562,5107604,3015
Meet the Blacks,9097072,0,9097072,4055940,1015
Carol,12711491,27560644,40272135,253510,4
Queen of Katwe,8874389,1492772,10367161,304933,52
Ratchet & Clank,8821329,4564408,13385737,4869278,2891
The Lobster,8700374,251977,8952351,190252,4
Dangal,12391761,291331875,303723636,3248481,331
A Beautiful Planet,15650615,10079505,25730120,223983,137
The Wild Life,8005586,32069860,40075446,3342696,2493
Loving,7751969,5205296,12957265,159615,4
Shut In,6900335,6181736,13082071,3613567,2058
The Brothers Grimsby,6874837,21104203,27979040,3258327,2235
The Danish Girl,11114018,53077505,64191523,187318,4
The Young Messiah,6490401,839937,7330338,3294876,1761
Jackie,13960394,10310005,24270399,278715,5
Southside with You,6304223,324380,6628603,2868403,813
Captain Fantastic,5879835,16907691,22787526,93824,4
Sultan,6200000,81080000,87280000,2371100,282
Lion,51738905,88574023,140312928,123360,4
Hunt for the Wilderpeople,5205468,17313922,22519390,78439,5
Bleed for This,5083906,1614773,6698679,2366810,1549
Incarnate,4799774,4237284,9037058,2534884,1737
Absolutely Fabulous: The Movie,4772155,34446954,39219109,1861118,313
Hands of Stone,4712792,265561,4978353,1751388,810
Don't Think Twice,4417667,0,4417667,92835,1
The Meddler,4267218,1027425,5294643,57022,4
Ae Dil Hai Mushkil,4264983,27403937,31668920,2190042,302
A Hologram for the King,4212494,4957013,9169507,1138578,401
Swiss Army Man,4210454,725047,4935501,105453,3
45 Years,4247285,10182964,14430249,65775,3
Denial,4073489,3921038,7994527,93728,5
Morgan,3915251,4894156,8809407,2012709,2020
Kabali,3903095,485694,4388789,2157621,236
The Man Who Knew Infinity,3866794,8385890,12252684,80325,6
Where to Invade Next,3827261,837495,4664756,897034,308
Max Steel,3818664,2453739,6272403,2182216,2034
Batman: The Killing Joke,3775000,687034,4462034,0,0
Midnight Special,3712282,3028365,6740647,190012,5
Anomalisa,3759286,1900000,5659286,135222,4
Rules Don't Apply,3652206,233136,3885342,1589625,2382
Miss Sloane,3500605,5600941,9101546,59797,3
Indignation,3401155,523372,3924527,93125,4
Everybody Wants Some!!,3400278,1244194,4644472,312355,19
Maggie's Plan,3351735,2532156,5883891,63308,5
A Man Called Ove,3479315,27212381,30691696,54608,9
Sing Street,3237118,10387404,13624522,63573,5
The Mermaid,3232685,550577543,553810228,985052,35
Green Room,3220371,548843,3769214,87984,3
Our Kind of Traitor,3153157,7557870,10711027,984698,373
Compadres,3127773,4225771,7353544,1397434,368
The Martian,228433663,401728227,630161890,54308575,3831
The Other Side of the Door,3000342,11332125,14332467,1211210,546
Spectre,200074609,680600000,880674609,70403148,3929
Anthropoid,2964845,2114374,5079219,1233519,452
The Beatles: Eight Days a Week - The Touring Years,2930414,9353386,12283800,785336,85
The Oscar Nominated Short Films 2016: Live Action,2816816,34024,2850840,559502,123
Ip Man 3,2679437,154275501,156954938,784839,103
Miles Ahead,2610896,863062,3473958,114530,4
Kapoor & Sons,2607036,14805591,17412627,986992,143
The Disappointments Room,2423468,3321572,5745040,1402823,1554
Hillsong: Let Hope Rise,2394386,255375,2649761,1357243,816
Dear Zindagi,2376479,823102,3199581,977862,153
A Aa,2313043,0,2313043,1213057,115
Fan,2300000,25940000,28240000,1382871,307
WARx2,2310625,0,2310625,30931,1
The Eagle Huntress,3169351,1230789,4400140,52574,4
Train to Busan,2129768,90558607,92688375,284776,27
I'm Not Ashamed,2082980,0,2082980,927161,505
A Bigger Splash,2024099,5521659,7545758,114419,5
The Dressmaker,2022115,21740302,23762417,185165,36
Desierto,2002036,2922954,4924990,514282,73
Greater,2000093,0,2000093,627974,340
Hidden Figures,169607287,66349611,235956898,515499,25
Demolition,1978592,2387868,4366460,1100042,854
In the Heart of the Sea,25020758,68900000,93920758,11053366,3103
The Peanuts Movie,130178411,116054702,246233113,44213073,3897
Shin Godzilla,1918403,76029204,77947607,458342,34
The Handmaiden,2006788,35686098,37692886,92129,5
Purple Rain,1868075,854,1868929,0,0
Bridge of Spies,72313754,93164594,165478348,15371203,2811
M.S. Dhoni: The Untold Story,1801550,27101497,28903047,1108650,256
Find a Boyfriend for My Wife... PLEASE!,1741889,2828868,4570757,902457,357
Billy Lynn's Long Halftime Walk,1738477,29192507,30930984,114129,2
Harry  Potter IMAX Marathon,1729226,55331,1784557,1357376,330
"To Joey, with Love",1709073,0,1709073,0,0
Weiner,1676108,39847,1715955,84173,5
Son of Saul,1777043,4882078,6659121,37930,3
I Saw the Light,1646788,121175,1767963,45471,5
Equity,1605463,66843,1672306,82434,4
Neerja,1585687,16032593,17618280,626528,73
Jane Got a Gun,1513793,1553738,3067531,835572,1210
Priceless,1499605,0,1499605,707021,303
Bajirao Mastani,6557047,4793870,11350917,1744975,304
Youth,2703296,20766244,23469540,78085,4
Genius,1361045,6073961,7435006,98274,16
The Little Prince,1339152,96232098,97571250,116927,52
The Neon Demon,1333124,2044306,3377430,589014,783
Embrace of the Serpent,1329249,1887927,3217176,50955,3
Housefull 3,1326999,617263,1944262,683620,145
Mohenjo Daro,1264339,365892,1630231,747791,246
Krampus,42725475,18823232,61548707,16293325,2902
Hotel Transylvania 2,169700110,305099890,474800000,48464322,3754
Lazer Team,1186426,220112,1406538,108586,35
The Music of Strangers: Yo-Yo Ma and the Silk Road Ensemble,1176781,82807,1259588,24614,3
Vaxxed: From Cover-Up to Catastrophe,1163265,0,1163265,28339,1
Dough,1148304,499125,1647429,50871,9
Wazir,1124045,4509543,5633588,586028,111
Papa Hemingway in Cuba,1115615,1784,1117399,475224,325
The Insanity of God,1102525,0,1102525,0,0
Certain Women,1087585,439113,1526698,60898,5
Rustom,1087419,571175,1658594,773662,133
The Innocents,1065665,6334659,7400324,30896,3
Elvis & Nixon,1055287,743145,1798432,466447,381
Battle for Incheon: Operation Chromite,1023348,1726570,2749918,31662,1
The Hollars,1016985,121624,1138609,38210,4
Trumbo,7857741,3572284,11430025,74177,5
Baar Baar Dekho,981947,347830,1329777,612363,146
Hubble 3D,52522904,21726825,74249729,413477,39
Goosebumps,80080379,78180573,158260952,23618556,3501
Dark Horse,940715,3346,944061,13838,3
Patterns of Evidence: Exodus,925576,0,925576,764309,652
Gentleman,897876,26008,923884,537490,126
Believe,890303,0,890303,477387,638
Elle,2341534,10407060,12748594,50934,2
Her & Him,857986,308795,1166781,439521,148
Mad Max: Fury Road,421986,0,421986,150000000,0
Premam,828278,6247,834525,448129,112
Kapow,812737,519185,1331922,442299,113
Operation Mekong,800012,173039060,173839072,85082,25
The Wailing,786633,49065137,49851770,77892,2
31,779820,70599,850419,0,0
Huo guo ying xiong,779818,57326609,58106427,201960,20
I Belonged to You,744541,118363039,119107580,311738,50
Saturday's Warrior,744046,0,744046,96041,9
The Monkey King 2,709982,192968316,193678298,166391,38
Little Men,702537,1306112,2008649,30368,2
Chaar Sahibzaade 2: Rise of Banda Singh Bahadur,700723,400224,1100947,303863,103
Mr. Church,685780,0,685780,338551,354
Mustang,845464,4429200,5274664,20321,3
Born to Be Wild,25978556,15665919,41644475,871478,206
Born to Be Blue,678203,723208,1401411,46184,3
American Honey,663246,1627403,2290649,71203,4
El Jeremías,650465,1889679,2540144,314109,192
City of Gold,640979,19466,660445,62959,4
Remember,637555,543468,1181023,20489,2
Mr. Six,1415450,137775895,139191345,332117,30
Range 15,621738,0,621738,1044,1
The Bronze,615816,0,615816,386328,1167
Tickled,613956,176563,790519,21898,2
Lo and Behold: Reveries of the Connected World,594912,170884,765796,114273,39
The Himalayas,696717,49847776,50544493,13387,3
Gleason,583664,0,583664,91583,9
A Tale of Love and Darkness,572212,152673,724885,37170,2
Teo-neol,568876,51875419,52444295,172521,36
Patriots Day,31886361,20299390,52185751,161306,7
Knight of Cups,566006,460282,1026288,60551,4
Cold War II,560824,102636677,103197501,157385,22
Harry & Snowman,561460,17360,578820,56842,18
American Pastoral,544098,1519338,2063436,149038,50
The Age of Shadows,541719,53949443,54491162,165685,33
Obsession,528799,2925910,3454709,347164,147
The First Monday in May,527474,545469,1072943,99242,20
Willy Wonka & the Chocolate Factory,526633,321,526954,526633,155
Unsullied,510957,0,510957,179112,102
Marguerite,506677,8247679,8754356,19924,3
The Boy and the Beast,490643,49223735,49714378,274247,122
Wiener-Dog,477453,257276,734729,24311,2
Dilwale,4871263,27123060,31994323,1920402,268
Detective Chinatown,474252,125368683,125842935,280281,33
Our Little Sister,467555,16004,483559,25118,3
Luck-Key,466505,48447470,48913975,113846,21
Only Yesterday,453243,72715,525958,14970,1
Gimme Danger,440627,509413,950040,44725,3
Baaghi,438207,238395,676602,237215,78
I Am Not Madame Bovary,436798,70389409,70826207,181552,38
Embrace: The Documentary,629126,526137,1155263,0,0
Voiceless,419952,0,419952,292438,100
The Lobster,376871,6127495,6504366,0,0
Mr. Donkey,356255,25181504,25537759,86931,20
Eat That Question,355074,10466,365540,16695,2
Happy Bhaag Jayegi,351840,74505,426345,159895,78
Kahaani 2,350703,182174,532877,279009,81
L.O.R.D: Legend of Ravaging Dynasties,350456,57739038,58089494,170676,68
High-Rise,346472,3940104,4286576,79887,39
Three,331507,60450,391957,258066,104
Kaashmora,327959,26672,354631,298674,70
Under the Sea 3D,36262926,19639698,55902624,661185,49
The Bounce Back,321910,99494,421404,227354,615
AmeriGeddon,316554,0,316554,125571,30
The Wasted Times,386540,17958832,18345372,95514,20
Francofonia,307040,701114,1008154,22083,2
Mia madre,303002,7420654,7723656,34098,6
Christine,298525,14940,313465,13384,1
April and the Extraordinary World,295488,200391,495879,11413,1
The People Vs. Fritz Bauer,288483,2795490,3083973,33781,6
Aquarius,285930,2800047,3085977,29129,3
Ixcanul,295157,299679,594836,0,0
Silence,7100177,16734632,23834809,130880,4
Kingsglaive: Final Fantasy XV,269980,5455502,5725482,119801,24
My Golden Days,269144,1240629,1509773,26847,3
The Family Fang,262921,386634,649555,14506,1
Minimalism: A Documentary About the Important Things,261865,0,261865,0,0
Dheepan,261819,5300756,5562575,20249,2
"Yo-kai Watch Movie: It's the Secret of Birth, Meow!",257343,47642462,47899805,0,0
"Life, Animated",255388,87276,342664,21883,3
Macbeth,1110707,15211360,16322067,69833,5
Love the Coopers,26302731,16124181,42426912,8317545,2603
Xun long jue,1243810,258124638,259368448,279974,22
Oasis: Supersonic,242867,1235252,1478119,16880,14
Things to Come,388140,5250553,5638693,31936,3
The Invitation,231737,123098,354835,67877,10
Jimmy Vestvood: Amerikan Hero,230069,60011,290080,60860,4
Galapagos,18630372,10718800,29349172,0,0
Miss Hokusai,222670,155032,377702,24524,2
Spirit of the Game,222565,0,222565,45580,24
Naam Hai Akira,219401,3888662,4108063,136644,71
Island of Lemurs: Madagascar,11272213,2794321,14066534,188307,37
Ho Mann Jahaan,208611,73315,281926,77548,19
Kaptaan,203790,92925,296715,109993,29
The Clan,201227,20180768,20381995,12519,3
White Girl,200242,0,200242,34058,3
The Fallen Idol,199619,0,199619,12136,2
Complete Unknown,191761,25712,217473,14149,2
Digimon Adventure tri. Part 1: Reunion,190581,0,190581,163005,457
The Intern,75764672,118800000,194564672,17728313,3305
The Masked Saint,182695,0,182695,123839,482
League of Gods,181633,43317133,43498766,84779,54
The Polar Express,765154,0,765154,165000000,0
The 33,12227722,15744301,27972023,5787266,2452
Viva,178008,245968,423976,48995,14
Julieta,1490948,20977096,22468044,64044,6
The Wave,177404,12797739,12975143,60321,33
Tampopo,224097,0,224097,16410,1
Asura,175702,18125141,18300843,21253,2
"Hieronymus Bosch, Touched by the Devil",172533,29374,201907,0,0
Apparition Hill,170457,0,170457,4152,1
The Fits,166425,2811,169236,10602,1
De Palma,165237,2808,168045,30355,3
Janis: Little Girl Blue,410465,1272701,1683166,21861,2
Louder Than Bombs,163807,996917,1160724,24259,4
The Night Before,43047372,9348624,52395996,9880536,2960
The Love Witch,228894,17324,246218,17980,6
Howards End,160282,193243,353525,23840,2
Beauty and the Beast,160215,0,160215,8264,1
Sunset Song,159714,1142768,1302482,12995,3
The Witness,159305,0,159305,14523,1
Eva Hesse,157481,0,157481,12780,1
Born to Be Blue,151926,0,151926,14069,23
Generation Found,151751,0,151751,0,0
Kicks,150191,0,150191,32111,3
Rams,149250,1677333,1826583,13289,3
Touched with Fire,146487,0,146487,16816,6
Krisha,144822,0,144822,9880,2
Psycho-Pass: The Movie,138366,0,138366,0,0
20th Century Women,5664764,1550042,7214806,111200,4
The Kind Words,135382,0,135382,8571,1
Tumbledown,135026,147057,282083,7331,2
Ism,134165,0,134165,120155,79
Devil and Angel,131058,98468884,98599942,44855,12
Requiem for the American Dream,130152,0,130152,0,0
Neruda,939101,2945645,3884746,29402,3
Chimes at Midnight,126724,0,126724,13630,2
Spirits' Homecoming,125616,23731601,23857217,10012,2
Sweet Bean,124800,4595210,4720010,4630,1
A War,122902,991761,1114663,9095,5
Theeb,283024,485425,768449,9181,3
Miss Sharon Jones!,120880,0,120880,10323,1
Hockney,120745,0,120745,13683,4
Three,119550,15001678,15121228,58196,23
Tale of Tales,118925,5378179,5497104,8871,2
Sicario,46889293,37983151,84872444,401288,6
Caged No More,114959,0,114959,69372,116
Yellow Day,144163,0,144163,26260,2
The Measure of a Man,112391,6406540,6518931,10011,2
The Boy and the World,129480,25735,155215,10077,2
Elevator to the Gallows,111267,0,111267,14334,1
Remember the Goal,119100,0,119100,70136,77
Zero Days,109649,0,109649,49110,18
Secret in Their Eyes,20180155,14674835,34854990,6652996,2392
Seasons,150092,11275008,11425100,27134,13
Aferim!,108110,242000,350110,15892,5
Dekalog,106494,0,106494,18532,3
Heart of a Dog,420813,55571,476384,13893,1
Until Forever,105358,13437,118795,26687,12
Dictator,104734,0,104734,30593,19
Demon,104038,0,104038,13023,3
Under the Sun,105036,200957,305993,15454,2
Puerto Ricans in Paris,102890,0,102890,26674,41
Victor,117755,0,117755,38594,12
Cameraperson,102033,7431,109464,12760,1
Best Worst Thing That Ever Could Have Happened...,106986,0,106986,23490,2
SEED: The Untold Story,207825,1755,209580,0,0
Our Last Tango,100086,405799,505885,6550,1
Rock on 2,98868,40305,139173,81023,97
Tower,101987,0,101987,0,0
Seondal: The Man Who Sells the River,97477,14680505,14777982,36415,7
So Young 2: Never Gone,96421,48884371,48980792,52134,21
Ingrid Bergman: In Her Own Words,138148,75866,214014,8355,1
Live by Night,10378555,12300000,22678555,33336,4
The Fight Within,94326,0,94326,57124,103
"New York, New York",92377,1452975,1545352,42239,16
Other People,91441,0,91441,36997,12
Morris from America,91151,0,91151,15673,2
Fireworks Wednesday,90519,0,90519,6132,1
I Married an Anti-Fan,89408,12104675,12194083,58767,22
Sand Storm,86800,327898,414698,6849,2
"My Love, Don't Cross That River",86446,0,86446,6340,2
Deep Sea,46412757,51818148,98230905,700213,43
Author: The JT LeRoy Story,85999,1687,87686,23413,5
Los Sures,83992,0,83992,26088,1
Mountains May Depart,82913,5127247,5210160,5550,1
Cock and Bull,82778,20408094,20490872,33231,12
A Street Cat Named Bob,82703,8363559,8446262,32887,24
Chi-Raq,2653032,66667,2719699,1198453,305
Vita Activa: The Spirit of Hannah Arendt,82143,24625,106768,13244,1
King Cobra,81757,0,81757,11624,1
Space Station 3D,93383953,34979928,128363881,489488,24
For the Love of Spock,80141,0,80141,0,0
Peggy Guggenheim: Art Addict,498428,229163,727591,22258,2
Dark Horse,90136,0,90136,1865,1
My Best Friend's Wedding,78578,5629192,5707770,39984,37
Sky on fire,78366,5257084,5335450,39589,21
Colliding Dreams,78288,0,78288,16438,4
Saala Khadoos,76931,17856,94787,76931,70
Toni Erdmann,1479387,10304820,11784207,15972,3
Don't Blink,76134,0,76134,10382,1
Sword Master,75526,14639098,14714624,40113,29
Michael Moore in TrumpLand,149090,0,149090,50200,2
Paterson,2152738,7435544,9588282,69335,4
The Brand New Testament,127910,15581742,15709652,10422,6
Raiders!: The Story of the Greatest Fan Film Ever Made,71916,0,71916,26059,24
Sweet 20,71775,3738654,3810429,24715,4
The Congressman,71451,0,71451,14260,3
Do Not Resist,72791,0,72791,7150,1
Norman Lear: Just Another Version of You,70950,0,70950,16912,2
Les Cowboys,73725,1228768,1302493,13178,4
The Dark Horse,67533,1794581,1862114,8152,2
Tamjung Hong Gil-dong: Sarajin Ma-eul,67054,9687141,9754195,7804,1
Max Rose,66680,0,66680,4000,1
Maze Runner: The Scorch Trials,81697192,230598864,312296056,30316510,3791
King Georges,66175,0,66175,15031,4
Ran,66097,18692,84789,11462,1
A Monster Calls,3740823,43568490,47309313,30909,4
Microbe & Gasoline,63802,239985,303787,11882,2
The Tenth Man,63564,231565,295129,0,0
Trapped,63241,0,63241,17626,3
Creative Control,63014,0,63014,6964,3
Dancer,71917,1059732,1131649,7140,1
Hitchcock/Truffaut,260430,126041,386471,28178,3
In a Valley of Violence,61797,0,61797,29343,33
The Messenger,67816,0,67816,0,0
Too Late,60438,0,60438,7000,1
Girl Asleep,60289,3767,64056,2567,1
Presenting Princess Shaw,60197,0,60197,4814,3
Time Renegades,59425,8252936,8312361,6068,1
Vanishing Time: A Boy Who Returned,57759,3270758,3328517,4156,2
Command and Control,57635,0,57635,5385,1
Sold,57527,0,57527,5070,1
Disorder,51879,409118,460997,11699,2
Fire at Sea,120933,1057444,1178377,0,0
Grandma,6980524,224549,7205073,115540,4
Burnt,13651946,22954797,36606743,5002521,3003
Journey to the South Pacific,7653913,7340963,14994876,8137,1
Pele: Birth of a Legend,57046,7789562,7846608,7226,3
Dongju: The Portrait of a Poet,56550,7752981,7809531,17724,5
Men & Chicken,30207,4735265,4765472,2654,2
Wedding Doll,56196,0,56196,2771,3
L'attesa,55804,954962,1010766,5686,2
The Lovers & the Despot,55511,40010,95521,14925,8
Voyage of Time: The IMAX Experience,55409,281629,337038,55409,15
The Battle of Algiers,56853,0,56853,13536,3
Regression,55039,17616062,17671101,33915,100
Clown,55007,4326596,4381603,26920,100
Our Little Sister,64441,15343174,15407615,0,0
Diary of a Chambermaid,54235,1917012,1971247,10053,2
My King,54114,7949217,8003331,6273,1
High Strung,53447,2031004,2084451,40708,100
The Club,52761,488754,541515,6514,2
Being 17,52713,1992506,2045219,8838,2
The Last Man on the Moon,52482,1399,53881,30880,13
Cemetery of Splendor,51950,46982,98932,7780,2
My Annoying Brother,51996,19110328,19162324,0,0
The Unknowns,51035,0,51035,15000,0
Like for Likes,50839,5664716,5715555,25107,18
In the Shadow of Women,50291,102511,152802,10431,2
The Take,50269,14807539,14857808,41546,100
In Order of Disappearance,50251,0,50251,5208,2
The Treasure,50203,32189,82392,13624,3
Fatima,50105,162123,212228,6221,1
Mifune: The Last Samurai,62279,0,62279,4296,1
To the Arctic 3D,14560838,9134550,23695388,270228,50
Ma ma,47258,1328451,1375709,8874,1
Remember,547009,2507927,3054936,27006,27
3 Weeks in Yerevan,45536,0,45536,29245,3
We Are X,45270,502856,548126,7526,1
Suffragette,4702420,27269676,31972096,76244,4
A Melody to Remember,44263,6515733,6559996,0,0
Nuts!,44230,0,44230,0,0
The Greasy Strangler,45878,21549,67427,22500,11
Danny Says,44213,0,44213,11244,16
Phantom of the Theatre,43955,13482888,13526843,21001,26
The Land,43756,0,43756,17958,2
Tanna,46654,55571,102225,5711,2
Mastizaade,43403,25180,68583,29878,46
Closet Monster,42166,194,42360,6118,1
Daughters of the Dust,40986,6301,47287,10842,1
Wild Oats,40598,207351,247949,21554,100
Is That a Gun in Your Pocket?,39928,0,39928,10422,2
The Homeless Billionaire,39493,0,39493,19771,1
La Notte,39236,0,39236,10547,2
Restored Me,38745,0,38745,0,0
Catching the Sun,38613,0,38613,0,0
Spa Night,38578,0,38578,7056,1
Germans & Jews,38100,0,38100,5024,1
Band of Outsiders,38004,0,38004,13252,2
Come What May,37766,1272052,1309818,9738,2
Trust Fund,36885,0,36885,18023,4
How to Let Go of the World: and Love All the Things Climate Can't Change,36386,0,36386,5800,1
Until Forever,35839,123033,158872,12445,5
Labyrinth of Lies,794452,3780304,4574756,22101,3
Summertime,35322,3683709,3719031,15413,6
Songs My Brothers Taught Me,34793,112144,146937,3430,1
Mr. Right,34694,572901,607595,25369,35
Phantom Boy,34362,186654,221016,4352,1
Sweet Sixteen,34327,22785375,22819702,21439,9
Eisenstein in Guanajuato,34282,42431,76713,9823,4
Last Cab to Darwin,34193,5508843,5543036,620,1
Gosanja: Dae-dong-yeo Ji-do,34034,7001778,7035812,9962,4
Off the Rails,34249,0,34249,8795,1
Equals,33258,2051370,2084628,9206,2
Multiple Maniacs,33036,5367,38403,9814,1
The Intervention,32919,0,32919,23316,17
Monster Hunt,32766,387020740,387053506,21074,45
Rurouni Kenshin Part I: Origins,32445,0,32445,0,0
Anesthesia,32163,46107,78270,6747,1
"Rio, I Love You",31982,0,31982,0,0
Under the Shadow,31900,101424,133324,13565,14
Paths of the Soul,31747,0,31747,2780,1
As I Open My Eyes,30989,19732,50721,4189,1
Pan,35088320,93300000,128388320,15315435,3515
River of Fundament,44840,0,44840,9938,1
Taxi,321642,3584585,3906227,22531,3
Being Charlie,30400,2564,32964,11872,4
From Afar,30169,118461,148630,5136,1
For a Few Bullets,30142,7830305,7860447,17138,15
Therapy for a Vampire,30115,0,30115,3361,2
The Seventh Fire,30112,865,30977,8277,2
"Kill Me, Deadly",36027,0,36027,11600,2
No Home Movie,32757,0,32757,0,0
The Best Democracy Money Can Buy,29500,0,29500,9511,1
The Dog Wedding,29495,0,29495,12132,1
Troublemakers: The Story of Land Art,29462,9109,38571,5424,4
The Last Princess,29259,4105996,4135255,11607,1
Time to Choose,29233,0,29233,12233,6
Valley of Love,28648,1235629,1264277,9849,2
"Rabin, the Last Day",28411,0,28411,7940,1
Take Me to the River,28041,0,28041,1509,1
Master,597251,51039164,51636415,72821,3
Kaili Blues,32164,903072,935236,4164,1
Unlocking the Cage,27284,0,27284,3708,1
Blackway,27079,399412,426491,16458,11
Neon Bull,26734,146485,173219,6413,1
Papa,26677,1329356,1356033,14644,20
Truth,2541854,2841243,5383097,66232,6
The Eyes of My Mother,27099,2440,29539,8908,5
Front Cover,26409,0,26409,6907,1
A Monster with a Thousand Heads,24852,2013,26865,3900,2
Standing Tall,26144,4296976,4323120,7488,2
The Winding Stream,33420,0,33420,3660,3
Cosmos,25856,8537,34393,3807,1
Chevalier,25696,51894,77590,5968,3
Gurukulam,25651,0,25651,0,0
Kate Plays Christine,25564,1800,27364,6175,1
Banjo,25531,0,25531,18320,30
The New Year's Eve of Old Lee,25358,8073943,8099301,15519,6
Disturbing the Peace,25287,0,25287,10907,2
Évolution,24770,31215,55985,6927,3
Sudden Fear,24476,0,24476,11126,13
"Right Now, Wrong Then",24470,656258,680728,5291,2
Love Thy Nature,41149,11798,52947,0,0
Lolo,24134,7639664,7663798,4242,1
Harmony,23248,407320,430568,760,3
The Hill Chris Climbed: The Gridiron Heroes Story,23487,0,23487,0,0
The Seasons In Quincy: Four Portraits of John Berger,28456,32811,61267,5304,1
Kamikaze 89,22440,0,22440,5613,1
Be Here Now,22424,0,22424,13577,11
Generation Startup,22271,0,22271,5756,1
Reparation,22267,0,22267,2649,1
Sanam Teri Kasam,22121,45615,67736,22121,32
The Black Dove,22517,0,22517,7124,2
Blue Jay,21626,0,21626,5159,1
Thank You for Your Service,21497,0,21497,344,1
Term Life,21256,222537,243793,13040,50
Already Tomorrow in Hong Kong,21206,0,21206,14966,10
Almost Holy,21142,2815,23957,4195,5
Legend,1872994,41100000,42972994,86836,4
Time Changer,20797,0,20797,2320,1
Band of Robbers,20555,0,20555,14827,11
The Sea of Trees,20444,830541,850985,1877,2
Love Me True,20100,0,20100,5759,2
"No Pay, Nudity",20017,0,20017,3221,3
This Last Lonely Place,20507,0,20507,6089,2
The Letters,1647416,0,1647416,700683,886
Woodlawn,14394097,7520,14401617,4002226,1553
Revelation: Dawn of Global Government,19107,0,19107,14975,2
Search Engines,19033,0,19033,3044,2
Ktown Cowboys,18863,0,18863,12523,4
Never,20431,0,20431,4312,2
Seoul Searching,18654,0,18654,8966,1
In Jackson Heights,121094,0,121094,15150,1
Pierrot le Fou,34371,0,34371,7922,1
The Channel,18319,0,18319,4214,1
Coming Through the Rye,18137,0,18137,3761,1
A Bit of Bad Luck,18089,0,18089,2480,2
Wildflower,18062,50515,68577,9237,8
Holy Hell,18051,0,18051,9238,3
The Romans,19705,0,19705,3256,1
I Knew Her Well,18010,0,18010,9312,1
Men Go to Battle,18006,0,18006,2087,1
Peter and the Farm,18123,0,18123,3844,1
How He Fell in Love,17575,0,17575,0,0
Streit's: Matzo and the American Dream,17506,0,17506,12065,3
Landfill Harmonic,17205,0,17205,3526,1
New World Order,20205,0,20205,2790,2
Sembene!,28059,0,28059,0,0
Tharlo,17091,144138,161229,5160,2
The Lion in Winter,18177,0,18177,5339,2
Always Shine,17102,0,17102,4211,1
Colonia,15709,3605337,3621046,0,0
Entertainment,55506,0,55506,5132,2
Five Nights in Maine,15587,0,15587,9059,10
Be Somebody,15395,0,15395,14129,15
Starcrossed,15263,0,15263,2826,2
Of Mind and Music,15073,25249,40322,932,1
1915,111682,0,111682,30448,8
Argentina,14869,8995,23864,2274,1
Remember You,14814,2830310,2845124,0,0
The Wanderers,14492,0,14492,2206,1
The Uncondemned,14393,0,14393,4353,1
Brother Nature,14218,0,14218,9699,17
Newtown,14109,0,14109,6796,2
Shangri-La Suite,14073,0,14073,13344,25
Yosemite,13931,0,13931,4461,2
The Fiancé,23986,0,23986,4812,4
The Comedian,1659002,0,1659002,10723,2
On the Map,17099,0,17099,151,1
A Space Program,13739,0,13739,10247,1
Tikkun,13671,0,13671,3595,2
The Duelist,13450,6088454,6101904,7576,10
Late Spring,13254,0,13254,6456,1
The Adderall Diaries,13191,2173,15364,5517,30
The Program,13074,3322539,3335613,5763,18
Censored Voices,41260,0,41260,6153,2
Neither Heaven Nor Earth,12810,105853,118663,2836,1
When Two Worlds Collide,12080,0,12080,2548,1
The Monster,12544,62156,74700,6624,18
City of Women,12516,0,12516,6244,1
The Ones Below,12488,109339,121827,5191,4
"Kiki, Love to Love",12450,7538832,7551282,3954,1
Elstree 1976,12173,0,12173,3270,14
Destiny,12156,0,12156,2334,1
Hot Water,12101,0,12101,1512,2
Kill Zone 2,11998,93626360,93638358,11998,13
History of Jazz: Oxygen for the Ears,23048,0,23048,7566,3
Lucha Mexico,11722,0,11722,7245,25
Don't Call Me Son,11678,192905,204583,2066,1
River of Grass,11553,0,11553,2942,1
The Ruins of Lifta,11548,0,11548,4620,1
Harry Benson: Shoot First,18092,0,18092,4798,3
Viktoria,11314,0,11314,2468,2
Jeruzalem,11287,95737,107024,11287,1
Theo Who Lived,11271,0,11271,4990,1
Hacker,11239,0,11239,6716,13
Flowers,61568,77853,139421,6572,1
What Happened Last Night,10844,0,10844,7147,25
A Reason,15792,0,15792,1690,3
A Matter of Faith,680113,0,680113,138677,25
National Bird,10656,0,10656,3030,1
Approaching the Unknown,10232,0,10232,6476,11
Beta Test,10104,0,10104,5778,18
Into the Forest,9995,82171,92166,6438,15
Made in France,9956,0,9956,3688,1
The Lost Arcade,9522,0,9522,7500,1
Southbound,23665,0,23665,6250,4
Hooligan Sparrow,9263,0,9263,0,0
Frank & Lola,9188,0,9188,5747,26
Chronic,9033,365671,374704,2403,2
The Last King,8905,3696713,3705618,4599,3
Providence,8840,0,8840,6193,7
Gone Doggy Gone,14354,0,14354,5625,2
Butterfly Girl,17503,0,17503,4326,2
Gabo: The Creation of Gabriel Garcia Marquez,19337,0,19337,1432,1
We Are Twisted Fucking Sister!,8277,0,8277,5804,6
The Olivia Experiment,15122,0,15122,2754,2
Mojave,8253,349,8602,3303,26
Silicon Cowboys,8239,0,8239,5724,12
NightLights,21147,0,21147,6414,3
Golden Kingdom,8077,0,8077,554,1
Pet,8004,13999,22003,63,1
The Other Side,8074,94,8168,1246,1
Talent Has Hunger,7998,0,7998,3709,1
Portrait of a Garden,7914,0,7914,4488,1
An Eye for Beauty,9395,36118,45513,0,0
Land of Mine,435266,2734287,3169553,0,0
Coming Up Roses,20567,0,20567,6432,2
I Don't Belong Anywhere: The Cinema of Chantal Akerman,7703,0,7703,389,2
The President,7578,7760,15338,0,0
They Will Have to Kill Us First: Malian Music In Exile,7516,7937,15453,4106,2
Tab Hunter Confidential,85812,0,85812,9945,2
Old Stone,7476,292,7768,1676,1
Noma: My Perfect Storm,21130,47492,68622,2987,4
Magnus,8944,92795,101739,1204,1
Ocean Waves,87738,0,87738,4942,1
Indian Point,7251,0,7251,3186,1
The Pearl Button,42166,77587,119753,0,0
It Had to Be You,7162,0,7162,5302,2
"Brutti, sporchi e cattivi",7144,0,7144,4898,1
The Preppie Connection,11558,0,11558,5576,2
Rosenwald,433924,0,433924,7902,1
The Brainwashing of My Dad,7028,0,7028,0,0
Boom Bust Boom,6896,0,6896,0,0
Mad Tiger,6823,0,6823,1119,1
Ghost Team,6639,0,6639,4499,10
The Dying of the Light,6627,0,6627,996,1
Spices of Liberty,13463,0,13463,6075,1
The Charnel House,6332,0,6332,4518,10
The Carer,6208,261787,267995,5102,1
Slash,5902,0,5902,0,0
Bourek,5844,0,5844,2692,1
Undrafted,5777,0,5777,3829,20
Klovn Forever,5700,7579869,7585569,860,5
Amy,8413144,15292905,23706049,222500,6
Hunter Gatherer,19462,0,19462,0,0
Welcome to Happiness,5083,0,5083,0,0
Dreams Rewired,11843,3783,15626,0,0
A Perfect Day,14044,3995396,4009440,0,0
Call Her Applebroog,4842,0,4842,2559,1
Roseanne for President!,7960,0,7960,3340,2
Marinoni: The Fire in the Frame,4696,0,4696,488,2
Blood on the Mountain,4664,0,4664,3184,2
Sworn Virgin,4636,104045,108681,830,1
Miss Stevens,4611,0,4611,2451,2
The Automatic Hate,4603,0,4603,2346,1
Search Party,4571,0,4571,3073,10
Synchronicity,4505,0,4505,2859,5
On Tour with Pina Bausch,18016,0,18016,1756,1
On Meditation,4322,0,4322,0,0
Auto Shop of Horrors,4300,0,4300,0,0
Maximum Ride,4218,0,4218,2462,10
Breaking a Monster,4212,0,4212,1302,1
Among the Believers,4189,0,4189,1900,1
The World of Kanako,16627,0,16627,6834,11
The Hollow,3755,0,3755,2848,12
Lamb,14547,16297,30844,3150,2
The Last Film Festival,3558,0,3558,0,0
Restored Me,3428,0,3428,1316,10
The Summer of Sangaile,4480,49363,53843,453,1
Burning Bodhi,3289,0,3289,1474,5
SK1,10330,0,10330,0,0
"Arabian Nights - Volume 1, The Restless One",12260,15985,28245,0,0
In Harmony,3144,3239301,3242445,809,1
Chosen,9283,253,9536,2449,1
Best and Most Beautiful Things,3016,0,3016,1591,2
The Bad Kids,6226,0,6226,1564,1
A Kind of Murder,2915,88234,91149,978,3
The Professor: Tai Chi's Journey West,2852,0,2852,1744,1
White Lies,2760,0,2760,1740,2
The Forbidden Room,34404,13678,48082,0,0
The Wonders,73378,2698980,2772358,0,0
Mekong Hotel,2502,0,2502,999,1
Homeland (Iraq Year Zero),2491,0,2491,560,1
The Loving Story,3518,0,3518,0,0
From the East,8540,0,8540,564,1
On War,5086,0,5086,2210,1
Ek Hazarachi Note,2404,0,2404,1697,1
Memoria,2242,0,2242,47,1
Vigilante Diaries,1991,174786,176777,1650,2
The Watermelon Woman,1989,0,1989,774,1
A Beautiful Now,1714,0,1714,148,1
Au nom de ma fille,1623,1064870,1066493,0,0
Miss India America,1598,0,1598,687,3
"Arabian Nights - Volume 2, The Desolate One",6398,8847,15245,0,0
Level Up,1469,22614,24083,0,0
The Silence of Mark Rothko,1422,0,1422,268,1
The Lovely Month of May,55038,0,55038,10662,3
Bikes vs Cars,28072,0,28072,0,0
A Small Good Thing,1196,0,1196,1196,2
Yalom's Cure,1164,765810,766974,684,1
The Ghosts of Johnson Woods,3000,0,3000,0,0
"Arabian Nights - Volume 3, The Enchanted One",4502,2179,6681,0,0
Officer Downe,850,0,850,470,2
Marius/Fanny/César,24787,0,24787,7720,1
Next Time I'll Aim for the Heart,815,3417398,3418213,310,1
The Student and Mister Henri,761,5411171,5411932,486,1
A Girl Like Grace,713,0,713,458,6
Down by Love,675,53105,53780,390,2
The Pit,560,0,560,0,0
Dark Star: HR Gigers Welt,61845,0,61845,8349,5
Moana,2993,0,2993,2274,1
Green is Gold,455,0,455,273,1
Legends from the Sky,91462,0,91462,18168,8
Far from Vietnam,8132,0,8132,1125,1
The Lady in the Car with Glasses and a Gun,2167,337294,339461,297,2
Hannah: Buddhism's Untold Journey,396,19130,19526,0,0
Tosca's Kiss,18236,0,18236,418,1
News from Planet Mars,310,37197,37507,24,1
Satanic,252,348931,349183,205,3
The Night Watchman,2219,0,2219,378,2
Star Wars: Episode VIII - The Last Jedi,620181382,712358507,1332539889,220009584,4232
Beauty and the Beast,504014165,759506961,1263521126,174750616,4210
Wonder Woman,412563408,409283604,821847012,103251471,4165
Guardians of the Galaxy Vol. 2,389813101,473942950,863756051,146510104,4347
Spider-Man: Homecoming,334201140,545965784,880166924,117027503,4348
It,327481748,372900000,700381748,123403419,4103
Thor: Ragnarok,315058289,538918837,853977126,122744989,4080
Despicable Me 3,264624300,770175109,1034799409,72434025,4529
Logan,226277068,392744368,619021436,88411916,4071
The Fate of the Furious,226008385,1009996733,1236005118,98786705,4310
Justice League,229024295,428900000,657924295,93842239,4051
Dunkirk,188045546,337200000,525245546,50513488,3720
Coco,209726015,597356181,807082196,50802605,3987
The Lego Batman Movie,175750384,136200000,311950384,53003468,4088
Get Out,176040665,79367304,255407969,33377060,2781
The Boss Baby,175003033,352962903,527965936,50198902,3773
Pirates of the Caribbean: Dead Men Tell No Tales,172558876,622302918,794861794,62983253,4276
Jumanji: Welcome to the Jungle,404515480,557562066,962077546,36169328,3765
Kong: Skull Island,168052812,398600000,566652812,61025472,3846
Hidden Figures,169607287,66349611,235956898,515499,25
Cars 3,152901115,231029541,383930656,53688680,4256
War for the Planet of the Apes,146880162,343839601,490719763,56262929,4022
Split,138291365,140162993,278454358,40010975,3038
Transformers: The Last Knight,130168683,475256474,605425157,44680073,4069
Rogue One: A Star Wars Story,532177324,523879949,1056057273,155081681,4157
Wonder,132422809,173514909,305937718,27547866,3096
La La Land,151101803,295384421,446486224,881104,5
Sing,270395425,363756254,634151679,35258145,4022
Girls Trip,115171585,25380774,140552359,31201920,2591
Fifty Shades Darker,114581250,266964596,381545846,46607250,3710
Baby Driver,107825862,119119225,226945087,20553320,3226
Annabelle: Creation,102092201,204423683,306515884,35006404,3502
Daddy's Home 2,104029443,76583737,180613180,29651193,3575
Murder on the Orient Express,102826543,249963268,352789811,28681472,3341
Kingsman: The Golden Circle,100234838,310667824,410902662,39023010,4003
John Wick: Chapter 2,92029184,79510703,171539887,30436123,3113
Blade Runner 2049,92054159,167185499,259239658,32753122,4058
The Emoji Movie,86089513,131687133,217776646,24531923,4075
Power Rangers,85364450,56972790,142337240,40300288,3693
The Mummy,80227895,329003712,409231607,31688375,4035
The Hitman's Bodyguard,75468583,101118118,176586701,21384504,3377
Alien: Covenant,74262031,166629732,240891763,36160621,3761
Captain Underpants: The First Epic Movie,73921000,51506681,125427681,23851539,3434
A Bad Moms Christmas,72110659,58449769,130560428,16759161,3615
A Dog's Purpose,64508620,140527199,205035819,18222810,3059
Pitch Perfect 3,104897530,80502815,185400345,19928525,3447
The Lego Ninjago Movie,59281555,63800000,123081555,20433071,4047
Baywatch,58060186,119796565,177856751,18503871,3647
The Shack,57386418,39555697,96942115,16172119,2888
Happy Death Day,55683845,69795421,125479266,26039025,3149
Ferdinand,84410380,211658819,296069199,13401586,3621
Atomic Blonde,51687870,48326155,100014025,18286420,3304
American Made,51342000,83524593,134866593,16776390,3024
The Dark Tower,50701325,62529753,113231078,19153698,3451
The Greatest Showman,174340174,260653009,434993183,8805843,3006
Boo 2! A Madea Halloween,47319572,1014360,48333932,21226953,2388
Lion,51738905,88574023,140312928,123360,4
Snatched,45852178,14993533,60845711,19542248,3501
The Great Wall,45540830,289393001,334933831,18469620,3326
Smurfs: The Lost Village,45020282,152163264,197183546,13210449,3610
Going in Style,45018541,39900000,84918541,11932330,3061
All Eyez on Me,44922302,10746396,55668698,26435354,2471
xXx: Return of Xander Cage,44898413,301219864,346118277,20130142,3651
Passengers,100014699,203129453,303144152,14869736,3478
47 Meters Down,44307191,17880338,62187529,11205561,2270
The Big Sick,42873127,13538458,56411585,421577,5
Moana,248757044,394574067,643331111,56631401,3875
Ghost in the Shell,40563557,129238364,169801921,18676033,3440
Valerian and the City of a Thousand Planets,41189488,184684740,225874228,17007624,3553
The Star,40852824,21960150,62812974,9812674,2837
King Arthur: Legend of the Sword,39175066,109500000,148675066,15371270,3702
Jigsaw,38052832,64900056,102952888,16640452,2941
American Assassin,36249674,30984514,67234188,14846778,3154
The Foreigner,34393507,110980592,145374099,13113024,2515
"Everything, Everything",34121140,27500000,61621140,11727390,2801
Wind River,33800859,10179962,43980821,161558,4
Geostorm,33700160,187900000,221600160,13707376,3246
Monster Trucks,33370166,31123749,64493915,10950705,3119
Fist Fight,32187017,8900000,41087017,12201873,3185
How to Be a Latin Lover,32149404,30397628,62547032,12252439,1118
Lady Bird,48958273,30007338,78965611,364437,4
Fences,57682904,6731857,64414761,129462,4
Patriots Day,31886361,20299390,52185751,161306,7
Kidnap,30971040,3843062,34814102,10016323,2378
Underworld: Blood Wars,30353973,50739340,81093313,13688751,3070
The Mountain Between Us,30348555,32483654,62832209,10551336,3088
Life,30234022,70307784,100541806,12501936,3146
Why Him?,60323786,57778939,118102725,11002986,2917
The Nut Job 2: Nutty by Nature,28370522,40372963,68743485,8342311,4003
Rings,27793018,55287872,83080890,13002632,2931
Logan Lucky,27780977,20672628,48453605,7600036,3031
Home Again,27020284,10250437,37270721,8567881,2940
Resident Evil: The Final Chapter,26830068,285412558,312242626,13601682,3104
The House,25584504,8600000,34184504,8724795,3134
Gifted,24801212,18245378,43046590,446380,56
"Three Billboards Outside Ebbing, Missouri",54513740,105678291,160192031,322168,4
The Bye Bye Man,22395806,7478474,29874280,13501349,2220
Victoria & Abdul,22245070,44313395,66558465,158845,4
Rough Night,22105643,25241640,47347283,8004283,3162
My Little Pony: The Movie,21885107,38445726,60330833,8885899,2528
Leap!,21858070,71791,21929861,4730038,2575
Sleepless,20783704,12133649,32917353,8344128,1803
Diary of a Wimpy Kid: The Long Haul,20738724,19402248,40140972,7126084,3157
Manchester by the Sea,47695371,31292777,78988148,256498,4
The Circle,20497844,20158555,40656399,9034148,3163
Baahubali 2: The Conclusion,20186659,233971731,254158390,10430497,425
Chips,18600152,8200000,26800152,7722802,2464
Assassin's Creed,54647948,186049908,240697856,10278225,2970
Only the Brave,18343983,8007339,26351322,6002665,2577
Darkest Hour,56468410,94378797,150847207,175006,4
The Disaster Artist,21120616,8700000,29820616,1211345,19
Mother!,17800004,26716995,44516999,7534673,2368
The Zookeeper's Wife,17571660,8581175,26152835,3288835,541
The Glass Castle,17273059,4815474,22088533,4678548,1461
Downsizing,24449754,30554136,55003890,4954287,2668
Flatliners,16883115,28275139,45158254,6574326,2552
Detroit,16790139,6564961,23355100,350190,20
The Shape of Water,63859435,131473877,195333312,166564,2
Moonlight,27854932,37481671,65336603,402075,4
The Case for Christ,14682684,3492979,18175663,3967885,1174
Wish Upon,14301505,9167081,23468586,5467084,2250
It Comes at Night,13985117,5750227,19735344,5988370,2533
Born in China,13873211,11207957,25081168,4790367,1508
Megan Leavey,13406883,1103607,14510490,3810867,1956
Father Figures,17501244,8100000,25601244,3287451,2902
The Founder,12786053,11335192,24121245,3404102,1115
All the Money in the World,25113707,31882597,56996304,5584684,2074
Battle of the Sexes,12638526,5960081,18598607,518332,21
Before I Fall,12241122,4132721,16373843,4690214,2346
"Roman J. Israel, Esq.",11962778,1063082,13025860,61999,4
Unforgettable,11368012,6400000,17768012,4785431,2417
Fantastic Beasts and Where to Find Them,234037575,580000000,814037575,74403387,4144
The Beguiled,10709995,17159134,27869129,229292,4
Live by Night,10378555,12300000,22678555,33336,4
The Belko Experiment,10166820,917810,11084630,4137230,1341
Thank You for Your Service,9536300,459392,9995692,3817700,2054
Marshall,10051659,65157,10116816,3000805,821
Rock Dog,9420546,13737100,23157646,3704749,2077
Arrival,100546139,102842047,203388186,24074047,2317
The Lost City of Z,8580410,10683528,19263938,110175,4
The Promise,8224288,4224388,12448676,4095718,2251
A Cure for Wellness,8106986,18513016,26620002,4356941,2704
The Space Between Us,7885294,8195181,16080475,3775596,2812
Jackie,13960394,10310005,24270399,278715,5
Gold,7227038,7653901,14880939,3471316,2166
Let There Be Light,7233471,0,7233471,1729535,373
I Am Not Your Negro,7123919,1221379,8345298,686378,43
Beatriz at Dinner,7115854,309537,7425391,141959,5
Birth of the Dragon,6901965,313062,7215027,2702430,1618
Silence,7100177,16734632,23834809,130880,4
The Snowman,6700035,36455226,43155261,3372565,1812
Collateral Beauty,31016021,57512259,88528280,7102085,3028
Same Kind of Different as Me,6423605,0,6423605,2591985,1362
Lowriders,6303560,8473,6312033,2403885,295
Loving Vincent,6735118,35452547,42187665,23180,1
Maudie,6170998,3562934,9733932,45920,4
Just Getting Started,6069605,1564417,7634022,3201459,2161
All Saints,5802208,140357,5942565,1514278,846
Suburbicon,5775178,6976489,12751667,2840246,2046
Paris Can Wait,5617731,7585810,13203541,98850,4
The Man Who Invented Christmas,5676486,2419521,8096007,1357129,626
20th Century Women,5664764,1550042,7214806,111200,4
Molly's Game,28780744,30503271,59284015,2349967,271
The Florida Project,5904366,5066932,10971298,157553,4
Your Name.,5017246,352968841,357986087,1813781,311
Office Christmas Party,54767494,59733805,114501299,16890204,3210
A Beautiful Planet,15650615,10079505,25730120,223983,137
Tiger Zinda Hai,5560921,81759079,87320000,1787108,299
Call Me by Your Name,18095701,23791894,41887595,412932,4
The Book of Henry,4504974,91731,4596705,1424540,579
Stronger,4211129,4292529,8503658,1611040,573
The Hero,4077333,24366,4101699,45317,4
Dangal,12391761,291331875,303723636,3248481,331
Sleight,3986245,3460,3989705,1701785,565
A United Kingdom,3902185,10557145,14459330,66510,4
Norman,3814868,2402699,6217567,99211,5
Friend Request,3759078,7216312,10975390,2002863,2573
A Monster Calls,3740823,43568490,47309313,30909,4
Table 19,3614896,1427118,5042014,1597928,868
Their Finest,3603484,8993778,12597262,76197,4
Phoenix Forgotten,3600146,0,3600146,1816499,1626
Trolls,153707064,193157398,346864462,46581142,4060
An Inconvenient Sequel: Truth to Power,3496795,1937131,5433926,124823,4
Til Death Do Us Part,3455267,0,3455267,1527289,562
Raees,3262954,5165236,8428190,1798379,265
Close Encounters of the Third Kind,3100479,1028,3101507,1767758,901
Colossal,3029287,1502033,4531320,120226,4
Ingrid Goes West,3024308,122523,3146831,135301,3
Leap!,2844490,81352927,84197417,181091,77
The Oscar Nominated Short Films 2017: Live Action,2835355,42442,2877797,692399,206
Kedi,2835047,2202876,5037923,40103,1
Doctor Strange,232641920,445076475,677718395,85058311,3882
Hacksaw Ridge,67209615,113241303,180450918,15190758,2886
Wolf Warrior 2,2721100,867604339,870325439,219022,53
My Cousin Rachel,2716368,6483800,9200168,969941,523
Showtime Championship Boxing: Floyd Mayweather vs. Conor McGregor,2620183,564201,3184384,2620183,532
A Question of Faith,2587072,0,2587072,1025489,661
Is Genesis History?,2570392,0,2570392,0,0
Disney's Newsies: The Broadway Musical!,2545060,0,2545060,1333538,780
IN OUR HANDS: Battle for Jerusalem,2534370,0,2534370,0,0
Do It Like An Hombre,2534252,11076000,13610252,1174484,382
LBJ,2470979,39172,2510151,1110565,659
Tulip Fever,2455635,6748914,9204549,1158017,765
"I, Tonya",30014539,23924758,53939297,264155,4
T2 Trainspotting,2402004,39279742,41681746,170575,5
Pokémon the Movie: I Choose You!,2401722,35150422,37552144,0,0
The Salesman,2402067,4551537,6953604,71078,3
Jeepers Creepers III,2335162,1682690,4017852,19151,10
The Resurrection of Gavin Stone,2303792,4563,2308355,1206771,890
The Killing of a Sacred Deer,2291901,4735435,7027336,115120,4
Collide,2280004,4537531,6817535,1512824,2045
The Lovers,2194521,21562,2216083,66286,4
The Patriarch,2156047,4000889,6156936,978894,312
Brad's Status,2133158,1683369,3816527,89921,4
Paterson,2152738,7435544,9588282,69335,4
Good Time,2026499,1256870,3283369,125101,4
Badrinath Ki Dulhania,1993259,24141050,26134309,862008,152
Everybody Loves Somebody,1915789,4566009,6481798,924201,333
A Quiet Passion,1865396,2293850,4159246,45825,6
Toilet: A Love Story,1830715,15736702,17567417,678436,178
The Wall,1803064,2673641,4476705,897955,540
Free Fire,1799312,1920071,3719383,994431,1070
The Last Word,1783421,1198583,2982004,31630,4
The Post,81903458,97865999,179769457,526011,9
Goodbye Christopher Robin,1735251,5666698,7401949,57917,9
Menashe,1703036,259229,1962265,62078,3
Slamma Jamma,1687000,0,1687000,1687000,502
When Harry Met Sejal,1664648,2743127,4407775,1284740,280
Jolly LLB 2,1654254,22559932,24214186,774355,173
The Little Hours,1647175,0,1647175,56676,2
The Comedian,1659002,0,1659002,10723,2
A Ghost Story,1596371,355312,1951683,104030,4
Professor Marston & the Wonder Women,1584759,314856,1899615,736883,1229
The Stray,1579440,0,1579440,596547,640
Genesis: Paradise Lost,1575000,0,1575000,0,0
Youth,1891956,225199334,227091290,338604,30
A Taxi Driver,1527829,84725111,86252940,331854,41
Sword Art Online The Movie: Ordinal Scale,1522976,27799363,29322339,196454,578
Inhumans,1521787,1330495,2852282,1135440,393
Mully,1489771,0,1489771,0,0
Jane,1723379,197842,1921221,58348,3
Elle,2341534,10407060,12748594,50934,2
Twins 2,1431255,27302268,28733523,638045,192
The Wedding Plan,1412404,129941,1542345,31658,8
Toni Erdmann,1479387,10304820,11784207,15972,3
The Dinner,1323312,1221609,2544921,653944,505
Julieta,1490948,20977096,22468044,64044,6
Wonder Wheel,1404061,14485063,15889124,125570,5
Personal Shopper,1305195,1535213,2840408,79175,4
My Friend Dahmer,1361611,75140,1436751,35545,4
Churchill,1281258,5443107,6724365,408891,215
The Sense of an Ending,1274420,3807075,5081495,39692,4
Chonda Pierce: Enough,1260116,0,1260116,0,0
3 idiotas,1249233,6489237,7738470,609249,349
True to the Game,1231040,0,1231040,472436,461
Steve McQueen: American Icon,1229782,0,1229782,0,0
The Square,1502347,7991444,9493791,74233,4
The Women's Balcony,1200885,71632,1272517,16620,2
Spirited Away,1196791,0,1196791,903896,632
The Trip to Spain,1157604,831237,1988841,40875,3
Step,1146292,6547,1152839,146488,29
Lady Macbeth,1129408,4272039,5401447,64537,5
Viceroy's House,1105717,10762504,11868221,48134,4
The Battleship Island,1104957,45078426,46183383,59344,1
Terminator 2: Judgment Day,1037809,2893302,3931111,552773,371
Wonderstruck,1060377,2225539,3285916,65882,4
Casablanca,1024560,0,1024560,596068,725
Columbus,1017107,75970,1093077,26820,2
Yu-Gi-Oh!: The Dark Side of Dimensions,1015339,6429847,7445186,656756,381
Hotchpotch Again,1013893,1027754,2041647,1013893,265
The Eagle Huntress,3169351,1230789,4400140,52574,4
Last Flag Flying,965481,907469,1872950,40558,4
Lucky,955925,1772521,2728446,43293,5
Landline,940854,0,940854,52555,4
Tubelight,930058,3720398,4650456,930058,338
The Red Turtle,921974,5669815,6591789,21010,3
Frantz,880883,6597471,7478354,18745,2
Journey to the West: The Demons Strike Back,880346,246704898,247585244,463883,67
The Polar Express,875150,0,875150,1321,0
Detective Jagga,861740,293122,1154862,490232,210
Neruda,939101,2945645,3884746,29402,3
Patti Cake$,800148,682208,1482356,67599,14
George Takei's Allegiance,784850,0,784850,784850,476
Mark Felt: The Man Who Brought Down the White House,768946,3603184,4372130,34217,5
Mubarakan,758868,12141100,12899968,310170,128
May It Last,725286,0,725286,9616,8
Revive Us 2,718607,0,718607,0,0
The Exception,708973,125599,834572,21351,2
Countdown to Canelo vs. Golovkin,703396,0,703396,703396,465
Chris Brown: Welcome To My Life,693984,0,693984,0,0
Titanic,691642,1661,693303,438602,87
Lost in Paris,691597,1395628,2087225,4510,1
Shubh Mangal Savdhan,689874,498667,1188541,259999,80
The Devotion of Suspect X,686435,58349229,59035664,323207,43
Walk With Me,726726,879979,1606705,9932,1
Wilson,653951,194695,848646,336227,310
Jonah: The Musical,631154,0,631154,0,0
The Only Living Boy in New York,624332,1925989,2550321,54458,15
Along With the Gods: The Two Worlds,1908823,107475149,109383972,185546,17
The Midwife,603582,6682554,7286136,21341,3
Battle of Memories,594552,43297810,43892362,224942,42
Faces Places,953717,3044733,3998450,31006,5
Master,597251,51039164,51636415,72821,3
Tommy's Honour,569306,182039,751345,209190,167
Novitiate,580346,0,580346,22724,3
Bitter Harvest,557241,347158,904399,219357,127
Allied,40098064,79421959,119520023,12701743,3160
Nocturnal Animals,10663357,19648500,30311857,492648,37
Samaritan's Purse presents Facing Darkness,555533,0,555533,0,0
Dolores,555309,0,555309,13534,1
Under the Sea 3D,36262926,19639698,55902624,661185,49
Brigsby Bear,532669,148963,681632,39652,3
Human Flow,527845,1296692,1824537,45677,3
Phantom Thread,21198205,26558385,47756590,216495,4
Fairy Tail: Dragon Cry,519461,900574,1420035,169203,292
Raw,514870,2581945,3096815,24825,2
Our President,507268,12884781,13392049,9421,1
Breathe,490131,4536023,5026154,22285,4
Once Upon A Time,485728,82400450,82886178,249933,51
Born to Be Wild,25978556,15665919,41644475,871478,206
Confidential Assignment,475618,55496623,55972241,21228,2
Beach Rats,473771,12852,486623,46451,3
Journey to the South Pacific,7653913,7340963,14994876,8137,1
Duckweed,471575,152422689,152894264,160739,27
DCI 2017 Tour Premeire,467817,0,467817,0,0
Phillauri,467596,5337434,5805030,260982,74
Chasing the Dragon,456854,87509088,87965942,138346,52
Sailor Moon R: The Movie: The Promise of the Rose,452053,0,452053,253490,145
Song to Song,443684,1334337,1778021,50559,4
Land of Mine,435266,2734287,3169553,0,0
One Piece Film: Gold,423593,65783480,66207073,50241,13
A Gentleman,410055,3028691,3438746,191530,135
"Love, Kennedy",407871,0,407871,45285,19
Chasing Trane: The John Coltrane Documentary,406284,0,406284,16626,1
The Accountant,86260045,68900000,155160045,24710273,3332
Samurai Cop,384756,0,384756,0,0
I'll Push You: A Real-Life Inspiration,378899,0,378899,0,0
Rebel in the Rye,378294,566076,944370,37967,4
Island of Lemurs: Madagascar,11272213,2794321,14066534,188307,37
BOSTON: An American Running Story,364369,0,364369,0,0
Kung Fu Yoga,362657,257380359,257743016,111979,14
Disney Junior HalloVeen Party!,359745,0,359745,0,0
Letters From Baghdad,359735,143206,502941,19725,2
OK Jaanu,355922,5089359,5445281,225968,121
Long Strange Trip - The Untold Story of The Grateful Dead,351957,0,351957,33272,56
Pearl Jam: Let's Play Two,348833,101440,450273,53177,5
Countdown to Canelo vs. Chavez Jr.,343387,0,343387,343387,273
This Is Not What I Expected,337670,30658945,30996615,135252,36
Dunkirk,1695119,0,1695119,122115,53
Chuck,320725,181793,502518,34565,4
Citizen Jane: Battle for the City,313411,9713,323124,31451,2
City Of Rock,312537,8806336,9118873,115524,43
A Silent Voice: The Movie,310407,29846056,30156463,121732,41
My Life as a Zucchini,309766,5562832,5872598,31853,2
God's Own Country,335609,2224330,2559939,17768,2
Tom of Finland,378296,1398635,1776931,13524,1
Obit.,315049,0,315049,0,0
Coincidence,298032,2222455,2520487,298032,67
Miss Peregrine's Home for Peculiar Children,87242834,209239612,296482446,28871140,3522
Loving,7751969,5205296,12957265,159615,4
Buddies in India,293194,109861934,110155128,181705,55
I Do... Until I Don't,280668,0,280668,170775,165
After the Storm,272132,5110754,5382886,27880,6
Stalker,269881,0,269881,20540,1
Storks,72679278,110709675,183388953,21311407,3922
Wakefield,262599,535615,798214,11299,1
"I, Daniel Blake",260354,15532697,15793051,18682,12
Cezanne et Moi,257597,4271986,4529583,15744,2
Dean,254536,0,254536,60366,15
Gook,250130,1411,251541,27044,2
Government 3,249588,109340,358928,164364,107
Band Aid,248370,0,248370,29013,3
Black Butler: Book of the Atlantic,248286,262846,511132,0,0
1945,1006193,234470,1240663,20365,2
The Swindlers,241916,29480000,29721916,82818,27
The Ottoman Lieutenant,240978,172866,413844,149830,216
Crown Heights,238558,0,238558,30173,3
American Satan,237708,0,237708,135378,55
Little Shop of Horrors,233865,0,233865,156288,511
Jeremiah Tower: The Last Magnificent,228153,0,228153,20268,2
The Breadwinner,312381,50926,363307,17395,3
California Typewriter,218563,0,218563,5031,1
Railroad Tigers,218044,101987131,102205175,116211,43
All I See Is You,217644,460506,678150,144076,283
The Adventurers,216556,36580260,36796816,68614,17
Truman,210840,8816760,9027600,18258,3
Donnie Darko,207971,4063,212034,57259,21
The Prison,207481,20997848,21205329,80376,23
Rumble: The Indians Who Rocked The World,226006,0,226006,0,0
Hubble 3D,52522904,21726825,74249729,413477,39
Risk,200219,14450,214669,76327,34
Spark: A Space Tail,196458,844231,1040689,116873,365
Almost Christmas,42158780,422140,42580920,15134235,2376
Embrace: The Documentary,629126,526137,1155263,0,0
The Fortress,252895,28392553,28645448,0,0
Whose Streets?,182799,0,182799,43804,24
The Bad Batch,180851,21039,201890,89111,30
Marjorie Prime,180608,33250,213858,20668,6
Past Life,180099,11579,191678,14960,4
Take Every Wave: The Life of Laird Hamilton,176076,47225,223301,12636,1
Graduation,175975,1839027,2015002,10305,2
Champion,175232,0,175232,108591,31
Mr. Gaga: A True Story of Love and Dance,173994,491623,665617,25354,2
In This Corner of the World,172147,19324161,19496308,24205,6
David Lynch: The Art Life,171419,140051,311470,10823,1
9/11,170000,30229,200229,170000,425
Valley of Bones,168738,0,168738,107393,300
"Polina, danser sa vie",165203,831222,996425,12588,2
13 Minutes,161531,234026,395557,11750,3
Manifesto,161101,255288,416389,9628,1
3 Generations,155936,524415,680351,105215,6
The Journey,155475,326734,482209,32895,2
Endless Poetry,153440,401266,554706,28591,2
Bombshell: The Hedy Lamarr Story,820300,271977,1092277,8000,1
Ex Libris: New York Public Library,158192,40047,198239,10926,1
The Void,151042,217330,368372,50026,31
The Unknown Girl,150549,2282091,2432640,13477,2
Blade of the Immortal,150532,7012085,7162617,49569,30
Jack Reacher: Never Go Back,58697076,103449000,162146076,22872490,3780
Restless Creature: Wendy Whelan,147780,0,147780,19879,2
The Ex-File 3: The Return of The Exes,838959,306753468,307592427,125291,21
The Last Dalai Lama?,145524,0,145524,9786,4
A Man Called Ove,3479315,27212381,30691696,54608,9
Irving Berlin's Holiday Inn The Broadway Musical,144550,0,144550,0,0
Chavela,148666,124176,272842,22453,4
Lupin the 3rd: Castle of Cagliostro,142425,9377,151802,0,0
The Other Side of Hope,183943,4099030,4282973,15495,3
The Handmaiden,2006788,35686098,37692886,92129,5
"Hare Krishna! The Mantra, the Movement and the Swami Who Started It",133006,0,133006,22310,1
Dawson City: Frozen Time,132369,0,132369,0,0
Thelma,147391,1316336,1463727,10841,1
Things to Come,388140,5250553,5638693,31936,3
Moka,129547,1363520,1493067,10094,1
City of Ghosts,128015,100210,228225,13601,2
Marie Curie: The Courage of Knowledge,127986,1772930,1900916,18600,6
The B-Side: Elsa Dorfman's Portrait Photography,125227,0,125227,12035,3
Buena Vista Social Club: Adios,123445,578130,701575,64469,80
Explosion,122700,7608710,7731410,55307,33
Inferno,34343574,185677685,220021259,14860425,3576
The Thousand Faces of Dunjia,124187,46139050,46263237,57837,27
Our Time Will Come,114560,9370154,9484714,50619,18
Big Sonia,212471,0,212471,4398,1
"We Love You, Sally Carmichael!",113435,0,113435,30951,7
Abacus: Small Enough to Jail,113278,0,113278,12528,1
The King's Choice,113231,9904085,10017316,7850,2
The Trouble with Terkel,110289,0,110289,32784,12
Reset,108970,29840282,29949252,54276,20
Slack Bay,112621,4621873,4734494,0,0
SEED: The Untold Story,207825,1755,209580,0,0
Like Crazy,107362,8921788,9029150,5799,2
Fabricated City,104874,18202616,18307490,24808,7
The Bolshoi Ballet: Live From Moscow - A Hero of Our Time,104837,30331,135168,104837,401
Walking Out,101947,60498,162445,5462,2
The Lure,101657,7189,108846,7370,1
Some Like It Hot,100026,95621294,95721320,42230,10
Munna Michael,99629,89476,189105,64949,75
"Tim Timmerman, Hope of America",97727,0,97727,50604,12
Poster Boys,97049,2505207,2602256,51264,50
The Mayor,96777,9379417,9476194,47128,29
Score,101382,82643,184025,8088,1
Keep Watching,94178,0,94178,0,0
The Fencer,95952,503585,599537,5572,2
Sully,125070033,115727590,240797623,35028301,3525
BPM (Beats Per Minute),125189,7579180,7704369,8566,2
Aida's Secrets,98468,0,98468,5665,1
Memoir of a Murderer,91335,18924011,19015346,27665,8
The King's Case Note,90959,11292534,11383493,8462,2
Because of Grácia,90878,0,90878,52171,32
Dina,90503,6021,96524,6015,1
Night of the Living Dead,89029,0,89029,5452,1
Hostiles,29819114,5849903,35669017,22849,3
Warriors of the Dawn,84532,5412644,5497176,41959,32
Chapter & Verse,84147,0,84147,31331,1
Space Station 3D,93383953,34979928,128363881,489488,24
Earth: One Amazing Day,81345,12770195,12851540,45480,70
The Nile Hilton Incident,81089,3898447,3979536,8183,2
Ocean Waves,87738,0,87738,4942,1
Stefan Zweig: Farewell to Europe,78372,604691,683063,11729,1
Harold and Lillian: A Hollywood Love Story,78301,0,78301,3510,2
Pop Aye,77976,126488,204464,3598,1
The Wasted Times,386540,17958832,18345372,95514,20
Te Ata,73236,0,73236,28640,14
Buster's Mal Heart,73121,0,73121,7137,1
Bad Santa 2,17782178,6297090,24079268,6176680,2920
Turn It Around: The Story of East Bay Punk,69787,0,69787,5211,1
Bill Nye: Science Guy,74909,0,74909,7005,1
My Entire High School Sinking Into the Sea,68883,0,68883,13684,3
To the Arctic 3D,14560838,9134550,23695388,270228,50
Alive and Kicking,68485,0,68485,12201,11
The Love Witch,228894,17324,246218,17980,6
Architects of Denial,65424,0,65424,58472,11
The Teacher,64437,1285989,1350426,15091,5
The Tiger Hunter,62398,0,62398,0,0
Tragedy Girls,61899,60312,122211,12125,2
Donald Cried,61406,0,61406,7977,2
Worlds Apart,60298,4951262,5011560,16353,1
Manolo: the Boy Who Made Shoes for Lizards,60056,4833,64889,8186,3
Bang! The Bert Berns Story,59299,0,59299,3923,1
The Boom,57962,0,57962,8164,1
Tomorrow,62510,11215395,11277905,1480,1
Happy End,301718,2309076,2610794,23091,3
The Brand New Testament,127910,15581742,15709652,10422,6
Fire at Sea,120933,1057444,1178377,0,0
Extraordinary Mission,54174,22703590,22757764,28649,20
God of War,53000,9506524,9559524,23912,27
The Paris Opera,55482,725557,781039,7709,4
The Divine Order,76277,118804,195081,0,0
My Journey Through French Cinema,52214,18960,71174,10636,3
Beautiful Accident,51766,2580326,2632092,25801,15
Tickling Giants,51499,0,51499,8159,1
The Ornithologist,50511,24203,74714,6132,2
I Called Him Morgan,128986,0,128986,12902,1
Person to Person,48499,0,48499,11852,3
Napping Princess,48198,1108649,1156847,10865,14
Tampopo,224097,0,224097,16410,1
From the Land of the Moon,47748,6477051,6524799,4473,2
So B. It,47627,0,47627,7455,2
Twenty Two,46796,8205,55001,22222,11
The Force,59912,0,59912,0,0
Saving Banksy,47965,0,47965,1317,1
Panique,46041,0,46041,7062,1
"Léon Morin, Priest",44511,0,44511,11462,1
Just One Drop,60078,0,60078,0,0
The Death of Louis XIV,43635,166080,209715,8002,1
Hermia & Helena,43152,1004,44156,12986,2
Bluebeard,43144,8812593,8855737,21234,14
Woodshock,42603,1079,43682,12247,3
Maurice,45926,0,45926,6972,1
One Week and a Day,41614,110564,152178,6833,3
The Settlers,41562,0,41562,0,0
Seasons,150092,11275008,11425100,27134,13
Karl Marx City,41072,0,41072,0,0
Unrest,40081,0,40081,10607,1
The Commune,38737,4371602,4410339,9249,7
I Am the Blues,37849,0,37849,5105,4
78/52: Hitchcock's Shower Scene,37664,9174,46838,3738,1
A Woman's Life,37626,858318,895944,11483,2
School Life,37381,49235,86616,2332,1
The Edge of Seventeen,14431633,4938387,19370020,4754215,1945
Heart Blackened,37047,3556433,3593480,0,0
Quest,47807,2215,50022,6591,1
Growing Up Smith,35312,0,35312,14867,5
Sophie and the Rising Sun,34630,0,34630,0,0
Rat Film,35195,0,35195,7793,2
Le Trou,34588,0,34588,6756,1
Dave Made a Maze,34117,0,34117,17135,17
Afterimage,33443,909586,943029,5832,1
Wasted! The Story of Food Waste,33211,0,33211,17189,11
Love & Taxes,33150,0,33150,1698,1
Alone in Berlin,33125,1172473,1205598,8869,2
Super Dark Times,33109,0,33109,19328,21
Sidemen: Long Road to Glory,31399,0,31399,6120,1
7 Witches,31100,0,31100,1875,1
XX,30911,24757,55668,6222,7
No Greater Love,30247,0,30247,21520,22
Dealt,30414,0,30414,4293,1
On the Beach at Night Alone,37489,391670,429159,7594,1
Deep Sea,46412757,51818148,98230905,700213,43
In Pursuit of Silence,29834,12079,41913,5141,1
Uncertain,29736,0,29736,0,0
Signature Move,31551,0,31551,18935,1
Lemon,29258,0,29258,5957,2
False Confessions,29245,26920,56165,7361,2
Berlin Syndrome,28660,369123,397783,22916,25
Brimstone & Glory,32059,3977,36036,2125,1
Wait for Your Laugh,73585,0,73585,14946,2
Mali Blues,26950,0,26950,0,0
Marius/Fanny/César,24787,0,24787,7720,1
Ribbons,27959,0,27959,5715,5
Radio Dreams,27836,0,27836,2712,1
The Villainess,27741,8709717,8737458,4238,1
The Untamed,27593,33656,61249,2718,1
The Crime of Monsieur Lange,36438,1564,38002,9633,1
30 Years of Garbage: The Garbage Pail Kids Story,27739,0,27739,5030,2
Nocturama,30157,291611,321768,5402,3
They Call us Monsters,26080,0,26080,0,0
Bronx Gothic,27151,0,27151,4696,1
The Old Dark House,25678,8971,34649,0,0
Saving Brinton,56218,0,56218,2690,1
Spettacolo,32494,0,32494,4403,2
Paradise,24749,0,24749,11845,4
The Departure,24662,0,24662,4850,1
Naples '44,24620,243,24863,6636,1
Jasmine,24248,0,24248,8358,3
Simple Creature,23918,0,23918,3006,3
Queen of Katwe,8874389,1492772,10367161,304933,52
"A Woman, a Part",23562,0,23562,5869,1
For Ahkeem,23136,0,23136,10500,3
Finding Oscar,23116,0,23116,2365,1
The Grace of Jake,23078,0,23078,4784,2
The Recall,22943,89414,112357,6570,7
My Scientology Movie,22936,2107930,2130866,11180,2
Una,22815,485354,508169,6120,1
Paradise Club,22381,0,22381,1758,2
The Transfiguration,22091,6540,28631,4605,1
The Lucky Man,25015,0,25015,4956,3
Bending the Arc,21907,14679,36586,3160,2
The Passion of Joan of Arc,21877,0,21877,6408,1
The Girl Without Hands,21787,99233,121020,2916,1
Trophy,21439,1114,22553,3522,1
God Knows Where I Am,21135,0,21135,0,0
Massacre on Aisle 12,21106,0,21106,967,1
A Beginner's Guide to Snuff,21031,0,21031,5204,3
Whisky Galore,20991,632875,653866,0,0
Man Underground,20907,0,20907,2194,3
All These Sleepless Nights,20762,0,20762,4544,3
The Blackcoat's Daughter,20435,17913,38348,12402,26
RV: Resurrected Victims,20374,2249518,2269892,10589,11
Better Watch Out,20369,155919,176288,12569,25
Absolutely Anything,20169,6283623,6303792,0,0
The Man from Outer Space,20102,0,20102,1962,2
Heat and Dust,19856,0,19856,10289,4
Trafficked,19698,0,19698,10413,17
L'important c'est d'aimer,19120,0,19120,5370,1
Contemporary Color,15305,0,15305,1451,1
Carrie Pilby,18957,9473,28430,13944,6
Bobbi Jene,18579,0,18579,7035,1
All the Rage,18489,0,18489,9765,1
Burden,18440,1997,20437,3231,2
Glory,18415,69313,87728,3716,2
Mansfield 66/67,17930,1460,19390,6451,1
The Last Shaman,17844,0,17844,6799,1
Sacred,17740,0,17740,4149,1
Bad Grandmas,17688,0,17688,3380,1
Harmonium,17191,136092,153283,3453,1
Food Evolution,17181,0,17181,2851,1
The Sacrifice,61018,0,61018,4696,1
Swim Team,16783,0,16783,4024,1
The Freedom to Marry,16611,0,16611,6142,1
Brave New Jersey,16544,0,16544,13437,14
Mission Control: The Unsung Heroes of Apollo,16405,0,16405,0,0
All the Queen's Horses,16172,0,16172,6573,1
Kills On Wheels,15898,3782,19680,380,1
Escapes,17778,0,17778,1339,1
Miss Sloane,3500605,5600941,9101546,59797,3
The Wound,30678,182365,213043,0,0
Hunter Gatherer,19462,0,19462,0,0
Victor,117755,0,117755,38594,12
SHOT! The Psycho-Spiritual Mantra of Rock,15157,3138,18295,6694,2
Rebels on Pointe,15088,0,15088,3270,2
Paradise,14873,906369,921242,2401,1
Vince Giordano: There's a Future in the Past,14807,0,14807,6285,1
The Farthest,14773,30148,44921,6900,2
Antarctica: Ice and Sky,14475,0,14475,0,0
Brotherhood of Blades 2,14204,39951888,39966092,5296,2
The Leisure Seeker,3226443,7245737,10472180,0,0
Abracadabra,13975,2100285,2114260,1942,10
Time to Die,13707,0,13707,3411,1
After Love,13693,1714558,1728251,810,1
Red Trees,13666,0,13666,10180,9
The Beatles: Eight Days a Week - The Touring Years,2930414,9353386,12283800,785336,85
Legend of the Naga Pearls,13588,17261107,17274695,5122,4
Charged: The Eduardo Garcia Story,15920,0,15920,0,0
In the Fade,321011,4783980,5104991,10455,3
Birdboy: The Forgotten Children,38786,13580,52366,5849,4
Taipei Story,12897,0,12897,7333,1
Song Of Granite,16182,5167,21349,3096,1
"Intent to Destroy: Death, Denial & Depiction",13194,0,13194,8699,3
Junction 48,12795,0,12795,5516,2
4 Days in France,12273,0,12273,3728,1
Last Men in Aleppo,14637,0,14637,1505,1
Heal,12668,0,12668,12668,1
Keep Quiet,50451,0,50451,6500,1
Blind,12522,85758,98280,12522,14
Seven Beauties,12408,0,12408,1536,1
The Magnificent Seven,93432655,68927981,162360636,34703397,3674
Staying Vertical,12158,444113,456271,4240,4
Frank Serpico,11925,0,11925,2283,1
Sweet Virginia,11753,2972,14725,5183,1
Dead Awake,11528,10147,21675,8834,12
The Son of Joseph,30588,8186,38774,0,0
Beside Bowie: The Mick Ronson Story,11400,0,11400,2100,1
I Can Speak,63239,23961205,24024444,0,0
Mifune: The Last Samurai,62279,0,62279,4296,1
Saigon Bodyguards,11314,0,11314,2252,1
Porto,15126,75723,90849,2090,1
Ugetsu,11197,13762,24959,6154,1
Shadowman,13498,0,13498,4113,1
The Challenge,11043,0,11043,2171,1
Permanent,12847,0,12847,5722,8
In Search of Fellini,12772,12497,25269,10796,3
Lovesong,10626,0,10626,1718,1
Clarence,10495,0,10495,5004,2
Harry & Snowman,561460,17360,578820,56842,18
Amelia 2.0,10233,0,10233,7836,1
The Sunshine Makers,10042,0,10042,1874,1
Pelle the Conqueror,9757,0,9757,1676,1
Machines,9710,4621,14331,2838,1
The Fiancé,23986,0,23986,4812,4
Remember the Goal,119100,0,119100,70136,77
Thirst Street,9129,0,9129,1737,1
Lycan,9110,0,9110,4970,5
Painted Woman,10298,0,10298,0,0
Galapagos,18630372,10718800,29349172,0,0
Amnesia,8700,0,8700,1202,1
Félicité,12433,253062,265495,1713,1
Inspector Maigret,8528,0,8528,2556,1
Irreplaceable,8494,15122418,15130912,1443,2
The Eyes,9104,0,9104,2075,1
We Are the Flesh,8438,0,8438,835,3
Natasha,8325,0,8325,8325,1
Mr. Chibbs,8302,0,8302,3163,1
Served Like a Girl,8290,0,8290,1844,4
From Nowhere,8109,0,8109,5408,2
Swept Away,7876,0,7876,1011,1
The Ballad of Lefty Brown,7856,0,7856,5559,2
Overdrive,7793,9642759,9650552,4797,20
Maurizio Cattelan: Be Right Back,7706,0,7706,0,0
The Wrong Light,7553,0,7553,5429,1
Birthright: A War Story,7519,0,7519,3006,1
Big Time,7347,0,7347,7347,2
Another WolfCop,7285,0,7285,5890,6
The Jazz Funeral,7103,0,7103,3792,2
A Kind of Loving,6912,0,6912,3278,1
Harry Benson: Shoot First,18092,0,18092,4798,3
Footnotes,6660,0,6660,5900,1
Suntan,6643,150624,157267,1629,1
The Persian Connection,6634,0,6634,6634,1
Elizabeth Blue,6542,0,6542,2948,10
The Pathological Optimist,11222,0,11222,5946,1
Scum,6461,0,6461,1948,1
The Last Rampage,6294,6650,12944,3054,18
Inseparables,6258,1858347,1864605,0,0
The Skyjacker's Tale,6253,0,6253,1097,1
In the Steps of Trisha Brown,6230,0,6230,1232,1
Chosen,9283,253,9536,2449,1
Arise from Darkness,6112,0,6112,0,0
The Fuzz,6067,0,6067,2236,2
Dying to Know: Ram Dass & Timothy Leary,16397,0,16397,0,0
Koroshiya 1,20285,0,20285,2750,1
The Seasons In Quincy: Four Portraits of John Berger,28456,32811,61267,5304,1
On Wings of Eagles,5975,0,5975,0,0
Starless Dreams,5937,0,5937,707,1
"Kill Me, Deadly",36027,0,36027,11600,2
Tad the Lost Explorer and the Secret of King Midas,5874,35698172,35704046,4028,100
The Work,5853,14701,20554,3286,2
Best Worst Thing That Ever Could Have Happened...,106986,0,106986,23490,2
The Dark Below,7095,0,7095,1526,1
The Vault,5728,341001,346729,4308,11
Trespass Against Us,5711,511486,517197,1620,20
The Ardennes,5638,3478,9116,840,1
La Chinoise,5631,0,5631,2340,1
Shut In,6900335,6181736,13082071,3613567,2058
No culpes al karma de lo que te pasa por gilipollas,5614,2236857,2242471,3660,10
Gold,5539,1522646,1528185,2571,10
Icaros: A Vision,5510,0,5510,5510,1
The Man from Earth: Holocene,5472,0,5472,3100,2
Reset,5454,68887,74341,2198,2
The Daughter,26376,1479058,1505434,0,0
Company Town,4934,0,4934,2150,1
Miss Kiet's Children,9384,0,9384,2035,2
Shot,4701,0,4701,0,0
Night School,4663,0,4663,1588,1
I Love You Both,4661,0,4661,3236,7
The Tribes of Palos Verdes,11603,0,11603,796,1
Shakespeare-Wallah,4650,0,4650,3378,1
A Boy Called Po,4550,0,4550,2693,10
Vengeance: A Love Story,4526,68744,73270,4526,11
The Pulitzer at 100,4489,0,4489,2577,1
German Concentration Camps Factual Survey,4468,0,4468,3000,1
30-LOVE,4392,0,4392,0,0
Bad Lucky Goat,5088,0,5088,170,3
My Father Die,4252,0,4252,3229,10
Singularity,4176,82646,86822,533,10
Badsville,4153,0,4153,3050,2
Dalida,3465,5619669,5623134,3170,1
Train to Busan,2129768,90558607,92688375,284776,27
Emily,3982,0,3982,1164,1
Dream Boat,3981,0,3981,2199,1
The Woman Who Left,3974,399,4373,2018,1
The Gender Card Flip,3774,0,3774,2978,1
Soul on a String,3669,487625,491294,1355,2
The Lovely Month of May,55038,0,55038,10662,3
La Belle Noiseuse,3540,0,3540,1887,1
Who's Crazy?,3497,0,3497,1355,1
"Love, Sweat and Tears",3482,0,3482,512,1
Spices of Liberty,13463,0,13463,6075,1
Speed Sisters,3423,0,3423,370,1
Amanda & Jack Go Glamping,3352,0,3352,0,0
Bad Match,3351,0,3351,0,0
On the Map,17099,0,17099,151,1
Planetarium,3262,543322,546584,625,1
Justice,3259,0,3259,2154,10
The Bad Kids,6226,0,6226,1564,1
Bugs,3742,0,3742,0,0
Tower,101987,0,101987,0,0
The Levelling,3040,115411,118451,160,1
Tanna,46654,55571,102225,5711,2
Kepler's Dream,2923,0,2923,1582,11
Demons,2900,0,2900,1202,2
1898: Our Last Men in the Philippines,2848,1992197,1995045,1844,10
I Dream in Another Language,2739,0,2739,810,1
No Home Movie,32757,0,32757,0,0
Santoalla,2684,0,2684,489,1
Daughter of the Nile,2640,0,2640,0,0
Take Me,2583,0,2583,2583,2
Apprentice,2578,58174,60752,0,0
New World Order,20205,0,20205,2790,2
Miles,2537,0,2537,2147,2
A Grin Without A Cat,43616,0,43616,8449,1
In Between,107977,1571975,1679952,5888,2
Under the Sun,105036,200957,305993,15454,2
Red Christmas,2255,0,2255,280,1
Behind the White Glasses,2223,2547,4770,900,1
7 from Etheria,2208,0,2208,940,1
Dayveon,2077,0,2077,1592,3
The Ghoul,2032,16427,18459,249,1
"Intent to Destroy: Death, Denial & Depiction",18340,0,18340,0,0
"Accidental Courtesy: Daryl Davis, Race & America",1940,0,1940,1452,1
Detour,1788,0,1788,145,5
The Polar Express,765154,0,765154,165000000,0
The Romans,19705,0,19705,3256,1
Magnus,8944,92795,101739,1204,1
The Greasy Strangler,45878,21549,67427,22500,11
The Battle of Algiers,56853,0,56853,13536,3
Never,20431,0,20431,4312,2
Level Five,27000,0,27000,7161,2
Do Not Resist,72791,0,72791,7150,1
Almost Friends,1481,34361,35842,0,0
The Outcasts,1455,59795,61250,1008,11
The Forest for the Trees,1410,0,1410,0,0
Believe,890303,0,890303,477387,638
Clash,18215,124906,143121,0,0
The Lion in Winter,18177,0,18177,5339,2
The Ghosts of Johnson Woods,3000,0,3000,0,0
It's Not Yet Dark,1227,4042,5269,811,2
The Loving Story,3518,0,3518,0,0
A Different American Dream,1172,0,1172,848,0
The Student,1126,316997,318123,0,0
Christine,298525,14940,313465,13384,1
The Penguin Counters,976,0,976,976,1
Always Shine,17102,0,17102,4211,1
Extraordinary Ordinary People,880,0,880,744,1
I Am Not Madame Bovary,436798,70389409,70826207,181552,38
Julian Schnabel: A Private Portrait,9103,0,9103,0,0
The Witness,159305,0,159305,14523,1
Amityville: The Awakening,742,8481255,8481997,742,10
Off the Rails,34249,0,34249,8795,1
The Black Dove,22517,0,22517,7124,2
La folle histoire de Max et Léon,543,8750135,8750678,0,0
The Eyes of My Mother,27099,2440,29539,8908,5
This Last Lonely Place,20507,0,20507,6089,2
Anatahan,8171,0,8171,0,0
2:22,422,3945307,3945729,294,3
The Hill Chris Climbed: The Gridiron Heroes Story,23487,0,23487,0,0
Paths of the Soul,31747,0,31747,2780,1
Justice Is Mind,14360,0,14360,5418,1
Peter and the Farm,18123,0,18123,3844,1
My Annoying Brother,51996,19110328,19162324,0,0
NightLights,21147,0,21147,6414,3
National Bird,10656,0,10656,3030,1
Made in France,9956,0,9956,3688,1
Black Panther,700059566,646853595,1346913161,202003951,4020
Avengers: Infinity War,678815482,1369544272,2048359754,257698183,4474
Incredibles 2,608581744,634223615,1242805359,182687905,4410
Jurassic World: Fallen Kingdom,417719760,890748184,1308467944,148024610,4475
Deadpool 2,318491426,416055185,734546611,125507153,4349
The Grinch,270620950,240975007,511595957,67572855,4141
Jumanji: Welcome to the Jungle,404515480,557562066,962077546,36169328,3765
Mission: Impossible - Fallout,220159104,570956000,791115104,61236534,4386
Ant-Man and the Wasp,216648740,406025399,622674139,75812205,4206
Solo: A Star Wars Story,213767512,179157295,392924807,84420489,4381
Venom,213515506,642569645,856085151,80255756,4250
A Star Is Born,215288866,220900000,436188866,42908051,3686
Aquaman,335061807,813400000,1148461807,67873522,4125
Bohemian Rhapsody,216428042,687227217,903655259,51061119,4000
A Quiet Place,188024361,152915000,340939361,50203562,3508
Ralph Breaks the Internet,201091711,328232251,529323962,56237634,4017
Crazy Rich Asians,174532921,64000000,238532921,26510140,3384
Hotel Transylvania 3: Summer Vacation,167510016,361073758,528583774,44076225,4267
Halloween,159342015,96143163,255485178,76221545,3928
Fantastic Beasts: The Crimes of Grindelwald,159555901,495300000,654855901,62163104,4163
The Meg,145443742,384800000,530243742,45402195,4118
Ocean's 8,140218711,157500000,297718711,41607378,4145
Ready Player One,137690172,445200000,582890172,41764050,4234
The Greatest Showman,174340174,260653009,434993183,8805843,3006
Mamma Mia! Here We Go Again,120634935,274409771,395044706,34952180,3317
The Nun,117450119,248100000,365550119,53807379,3876
Peter Rabbit,115253424,236013009,351266433,25010928,3725
Creed II,115715889,98500000,214215889,35574710,3441
Spider-Man: Into the Spider-Verse,190241310,185299521,375540831,35363376,3813
Mary Poppins Returns,171958438,177579056,349537494,23523121,4090
Star Wars: Episode VIII - The Last Jedi,620181382,712358507,1332539889,220009584,4232
The Equalizer 2,102084362,88315795,190400157,36011640,3388
Rampage,101028233,327000000,428028233,35753093,4101
A Wrinkle in Time,100478608,32197256,132675864,33123609,3980
Fifty Shades Freed,100407760,271577258,371985018,38560195,3768
Christopher Robin,99215042,98529335,197744377,24585139,3602
I Can Only Imagine,83482352,2592758,86075110,17108914,1629
Smallfoot,83240103,130800000,214040103,23045635,4131
The Post,81903458,97865999,179769457,526011,9
Night School,77339130,25766748,103105878,27257615,3010
Bumblebee,127195589,340794056,467989645,21654047,3550
The First Purge,69488745,67567517,137056262,17374280,3031
Game Night,69179066,48500000,117679066,17005332,3488
Book Club,68566296,35871892,104438188,13582231,2781
The House with a Clock in Its Walls,68549695,62907452,131457147,26608020,3592
Skyscraper,68420120,236448841,304868961,24905015,3782
Insidious: The Last Key,67745330,100140258,167885588,29581355,3116
Instant Family,67363237,53192964,120556201,14504315,3286
The Mule,103804407,71000000,174804407,17509431,2588
Blockers,60311495,33705799,94017294,20556350,3379
Pacific Rim: Uprising,59874525,231055623,290930148,28116535,3708
Tomb Raider,58250803,216400000,274650803,23633317,3854
Maze Runner: The Death Cure,58032443,230142892,288175335,24167011,3787
Tag,54730625,23400000,78130625,14947396,3382
The Nutcracker and the Four Realms,54858851,119102218,173961069,20352491,3766
A Simple Favor,53548586,44096031,97644617,16011689,3102
Life of the Party,53059911,12800000,65859911,17886075,3656
The Predator,51024708,109517426,160542134,24632284,4037
Overboard,50316123,40928790,91244913,14711101,1623
Sicario: Day of the Soldado,50072235,25765508,75837743,19007566,3055
I Feel Pretty,48795601,45743825,94539426,16030218,3440
BlacKkKlansman,49275340,44125483,93400823,10845330,1512
The Shape of Water,63859435,131473877,195333312,166564,2
Red Sparrow,46874505,104698129,151572634,16853422,3056
Breaking In,46840590,4571030,51411620,17630285,2537
Goosebumps 2: Haunted Halloween,46700633,46619747,93320380,15802225,3521
12 Strong,45819713,21631102,67450815,15815025,3002
Den of Thieves,44947622,35562000,80509622,15206108,2432
First Man,44936545,60760870,105697415,16006065,3640
Hereditary,44069456,36131480,80200936,13575172,2964
Tyler Perry's Acrimony,43549096,2854573,46403669,17170707,2006
Sherlock Gnomes,43242871,47254907,90497778,10604774,3662
Uncle Drew,42469946,4194468,46664414,15242781,2742
Widows,42402632,33582068,75984700,12361307,2803
Pitch Perfect 3,104897530,80502815,185400345,19928525,3447
Truth or Dare,41411015,53919478,95330493,18667855,3029
Paddington 2,40891591,187086932,227978523,11001961,3702
"Love, Simon",40826341,25489948,66316289,11756244,2402
Darkest Hour,56468410,94378797,150847207,175006,4
The Commuter,36343858,83598529,119942387,13701452,2892
The 15:17 to Paris,36276286,20800000,57076286,12554286,3042
Mile 22,36108758,30200000,66308758,13710825,3520
Alpha,35857181,62346015,98203196,10352512,2719
Peppermint,35418723,18500000,53918723,13423255,2980
Death Wish,34017028,15545682,49562710,13010267,2847
The Spy Who Dumped Me,33562069,41758611,75320680,12103043,3111
Annihilation,32732301,10338614,43070915,11071584,2012
Green Book,85080171,236672485,321752656,320429,25
Isle of Dogs,32015231,32226268,64241499,1620294,27
Nobody's Fool,31713110,1992223,33705333,13743111,2468
Adrift,31445012,28500000,59945012,11603039,3015
Ferdinand,84410380,211658819,296069199,13401586,3621
Robin Hood,30824628,55664403,86489031,9195670,2827
Super Troopers 2,30617396,1008990,31626386,15181624,2038
Slender Man,30569484,21169065,51738549,11371866,2358
"Three Billboards Outside Ebbing, Missouri",54513740,105678291,160192031,322168,4
Coco,209726015,597356181,807082196,50802605,3987
Teen Titans GO! to the Movies,29790236,22300000,52090236,10411189,3188
Hostiles,29819114,5849903,35669017,22849,3
The Hate U Give,29719483,5214526,34934009,512035,36
"I, Tonya",30014539,23924758,53939297,264155,4
Searching,26020957,49441080,75462037,388769,9
Winchester,25091816,18927772,44019588,9307626,2480
The Strangers: Prey at Night,24586708,6452418,31039126,10402271,2464
White Boy Rick,24011188,1946294,25957482,8860431,2504
Second Act,39282227,33000000,72282227,6489983,2607
Molly's Game,28780744,30503271,59284015,2349967,271
Won't You Be My Neighbor?,22835787,8670,22844457,475419,29
Overlord,21704844,19953000,41657844,10202108,2859
Holmes & Watson,30573626,9893344,40466970,7411522,2776
Proud Mary,20877013,876352,21753365,9959053,2125
The Happytime Murders,20706452,6800000,27506452,9532425,3256
Phantom Thread,21198205,26558385,47756590,216495,4
SuperFly,20545116,235569,20780685,6870740,2220
Vice,47836282,28237206,76073488,7768371,2442
Show Dogs,17857020,21299834,39156854,6023972,3212
Bad Times at the El Royale,17839115,14043609,31882724,7132647,2808
Operation Finale,17612099,0,17612099,6022758,1818
"Paul, Apostle of Christ",17560475,8355491,25915966,5172585,1473
Lady Bird,48958273,30007338,78965611,364437,4
Sorry to Bother You,17493096,677611,18170707,727266,16
Chappaquiddick,17395520,867950,18263470,5765854,1560
Forever My Girl,16376066,0,16376066,4245630,1114
The Favourite,34366783,61551923,95918706,422410,4
Hunter Killer,15767460,15905218,31672678,6653777,2728
Mortal Engines,15951040,67721633,83672673,7559850,3103
The Girl in the Spider's Web,14841338,20323582,35164920,7810112,2929
The Possession of Hannah Grace,14837422,28179106,43016528,6401744,2065
RBG,14017361,423931,14441292,578470,34
Eighth Grade,13539709,807724,14347433,263797,4
Call Me by Your Name,18095701,23791894,41887595,412932,4
The Darkest Minds,12695691,28446688,41142379,5842609,3127
All the Money in the World,25113707,31882597,56996304,5584684,2074
Three Identical Strangers,12320845,1127652,13448497,171503,5
Upgrade,11977130,4616424,16593554,4670905,1457
Padmaavat,11846060,11145000,22991060,4493384,326
Free Solo,17541090,11777771,29318861,294288,4
The Old Man & the Gun,11277120,6583277,17860397,142131,5
Hell Fest,11107431,7052260,18159691,5130963,2297
Wonder,132422809,173514909,305937718,27547866,3096
The Miracle Season,10230620,0,10230620,3950652,1707
Mary Queen of Scots,16468499,30241784,46710283,194777,4
Midnight Sun,9561064,17804403,27365467,4003993,2173
Tully,9369755,6266707,15636462,3282610,1353
Traffik,9186156,329758,9515914,3941338,1046
Unfriended: Dark Web,8866745,7158242,16024987,3653035,1546
Welcome to Marwen,10763520,2297971,13061491,2354205,1911
Early Man,8267544,46355270,54622814,3190525,2494
The Wife,9601092,10377097,19978189,108284,4
The Death of Stalin,8047856,16598199,24646055,184805,4
They Shall Not Grow Old,17956913,1173098,19130011,0,0
Sanju,7909317,68783735,76693052,2723349,356
Unsane,7732899,6560702,14293601,3762145,2023
Beautiful Boy,7649973,8986631,16636604,218888,4
Can You Ever Forgive Me?,8803865,3638296,12442161,161510,5
Mid90s,7362439,1940583,9303022,258157,4
Downsizing,24449754,30554136,55003890,4954287,2668
Dog Days,6809080,33276,6842356,2554766,2442
Boy Erased,6788692,5064389,11853081,207057,5
Hotel Artemis,6708147,6605434,13313581,3232790,2407
A-X-L,6501381,1966316,8467697,2798229,1710
Fahrenheit 11/9,6352306,321862,6674168,3008563,1719
Unbroken: Path to Redemption,6216897,0,6216897,2238723,1620
The Hurricane Heist,6115825,26401423,32517248,3024399,2402
Every Day,6102076,4319771,10421847,3016149,1667
Leave No Trace,6046104,1636824,7682928,219140,9
Once Upon a Deadpool,6100309,45147259,51247568,2683200,1566
Death of a Nation,5885881,0,5885881,2356522,1005
Pandas,7574012,61766,7635778,158915,33
My Hero Academia: Two Heroes,5754556,15268168,21022724,1388499,508
God's Not Dead: A Light in Darkness,5728940,1685238,7414178,2689677,1693
Kin,5718096,4594923,10313019,3035618,2141
Colette,5137622,9135411,14273033,161179,4
Action Point,5059608,44055,5103663,2390164,2032
Beirut,5019226,2490210,7509436,1734497,755
Gringo,4969853,6031774,11001627,2722420,2404
Samson,4719928,153897,4873825,1942569,1249
Father Figures,17501244,8100000,25601244,3287451,2902
Johnny English Strikes Again,4412170,154558606,158970776,1638895,544
Gotti,4343227,2069122,6412349,1719902,503
Blindspotting,4333394,673595,5006989,338999,14
Burn the Stage: The Movie,4201819,16145694,20347513,2420197,629
Ya veremos,4165949,9968774,14134723,1803848,369
Life Itself,4102648,3895126,7997774,2123463,2609
Sgt. Stubby: An American Hero,4015935,916759,4932694,1164403,1633
Thor: Ragnarok,315058289,538918837,853977126,122744989,4080
Gosnell: The Trial of America's Biggest Serial Killer,3679893,0,3679893,1162988,673
Indivisible,3511417,78216,3589633,1503101,830
The Oscar Nominated Short Films 2018: Live Action,3508777,2346,3511123,695044,198
Disobedience,3498782,4504398,8003180,237393,5
Justice League,229024295,428900000,657924295,93842239,4051
First Reformed,3448256,414242,3862498,97562,4
"Juliet, Naked",3444895,1063365,4508260,60886,4
Bad Samaritan,3435047,1188789,4623836,1726868,2007
7 Days in Entebbe,3326885,5444547,8771432,1592645,838
The Disaster Artist,21120616,8700000,29820616,1211345,19
2001: A Space Odyssey,3236321,587129,3823450,202759,4
2.0,4152000,6695903,10847903,2775000,314
The Leisure Seeker,3226443,7245737,10472180,0,0
The Sisters Brothers,3143056,10000000,13143056,115575,4
Thoroughbreds,3072605,114650,3187255,1224430,549
Whitney,3026351,1578772,4605123,1265572,451
American Animals,2856954,1223119,4080073,134793,4
God Bless the Broken Road,2846257,1976,2848233,1386254,1272
La boda de Valentina,2783739,8238055,11021794,1147073,331
Bharath Ane Nenu,2663090,613167,3276257,2663090,305
You Were Never Really Here,2528078,6832436,9360514,132829,3
A Beautiful Planet,15650615,10079505,25730120,223983,137
Suspiria,2483472,5458621,7942093,184037,2
The Rider,2419031,1015932,3434963,42244,3
Mary and the Witch's Flower,2418404,39560027,41978431,348475,161
Hearts Beat Loud,2386251,30914,2417165,74524,4
1991,2342264,0,2342264,328828,83
Papillon,2335896,7725007,10060903,1090073,544
Daddy's Home 2,104029443,76583737,180613180,29651193,3575
Murder on the Orient Express,102826543,249963268,352789811,28681472,3341
If Beale Street Could Talk,14915773,5680794,20596567,224476,4
Simmba,5102129,4744324,9846453,1758576,301
The Fall of the American Empire,2178460,1932468,4110928,338216,72
Puzzle,2032018,228928,2260946,61214,5
Great Performances at the Met: Puccini: Tosca,2023749,1449867,3473616,1498309,691
A Fantastic Woman,2020988,1681365,3702353,64241,5
Pope Francis: A Man of His Word,2008385,6600000,8608385,507870,346
Assassination Nation,2005142,579846,2584988,1050021,1403
The Front Runner,2000105,1242130,3242235,51543,4
Detective Chinatown 2,1983984,542201172,544185156,704047,115
Great Performances at the Met: Verdi: La Traviata,1882931,99657,1982588,1333159,725
Ben Is Back,3703184,6431020,10134204,80734,4
At Eternity's Gate,2294915,8947689,11242604,92856,4
Moses,1807117,0,1807117,416047,673
Great Performances at the Met: Puccini: La Bohème,1764201,0,1764201,1326339,687
Race 3,1690861,5126530,6817391,1690861,314
On the Basis of Sex,24622687,14051063,38673750,686355,33
Pad Man,1670192,27374828,29045020,740313,152
A Private War,1633208,2281999,3915207,60491,4
Great Performances at the Met: Verdi: Aida,1595902,0,1595902,1187275,699
The Bookshop,1588150,10467718,12055868,75736,4
Operation Red Sea,1543547,577786879,579330426,436059,45
Thugs of Hindostan,1449848,12891583,14341431,1185386,377
"Don't Worry, He Won't Get Far on Foot",1441705,2799951,4241656,83339,4
Princess Mononoke,1423877,95444,1519321,476728,731
Finding Your Feet,1418682,14426911,15845593,60132,14
Made for More,2999134,0,2999134,0,0
Little Women,1379497,10786393,12165890,705063,643
Dunkirk,1695119,0,1695119,122115,53
102 Not Out,1343797,15414799,16758596,483681,102
Baaghi 2,1319579,31819484,33139063,650722,123
Great Performances at the Met: Mozart: Così fan tutte,1302949,0,1302949,966870,687
McQueen,1257275,1481971,2739246,98873,4
The Seagull,1252960,567501,1820461,79016,6
Great Performances at the Met: Massenet: Cendrillon,1243306,503953,1747259,925752,684
Racetime,1875283,1563770,3439053,271061,86
Shoplifters,3313513,64685822,67999335,89264,5
Mandy,1214525,120959,1335484,225723,75
Maria By Callas,1267301,918261,2185562,91915,16
Grease,1213413,614275,1827688,664766,700
Beautifully Broken,1209645,61927,1271572,589155,651
An Interview with God,1201434,1050361,2251795,0,0
Along With the Gods: The Last 49 Days,1200246,96761992,97962238,311743,48
Great Performances at the Met: Saint-Saëns: Samson et Dalila,1195758,0,1195758,898384,699
Andhadhun,1193046,48198160,49391206,278677,56
Spirited Away,1175067,69010962,70186029,494054,720
Great Performances at the Met: Verdi: Luisa Miller,1166858,0,1166858,850777,685
Lean on Pete,1163056,1280528,2443584,46975,4
Along With the Gods: The Two Worlds,1908823,107475149,109383972,185546,17
My Neighbor Totoro,1144649,25939208,27083857,539245,718
Great Performances at the Met: Donizetti: L'Elisir d'Amore,1115018,0,1115018,837262,687
Qué León,2607916,5200000,7807916,291936,34
The Dark Crystal,1036956,0,1036956,548354,609
Zero,1035388,1560374,2595762,1035388,300
Great Performances at the Met: Rossini: Semiramide,1033651,299249,1332900,798605,691
Great Performances at the Met: Puccini: La Fanciulla del West,1023233,0,1023233,765549,705
Nothing to Lose,1016188,35059129,36075317,679531,69
Elvis: The Comeback Special,1010657,0,1010657,0,(
Raid,1010385,1020750,2031135,423817,79
Wildlife,1050616,2270751,3321367,104589,4
The Insult,1001305,2600298,3601603,24957,3
Labyrinth,993336,0,993336,558857,576
Yellow Submarine,992305,280956,1273261,107105,73
Little Italy,990230,372306,1362536,283399,133
Tiger Zinda Hai,5560921,81759079,87320000,1787108,299
Film Stars Don't Die in Liverpool,1026124,3021793,4047917,36048,4
The Dawn Wall,970032,471981,1442013,0,0
White Christmas,928298,0,928298,566045,638
Kirk Cameron: Connect,918127,0,918127,0,0
The Miseducation of Cameron Post,904703,569874,1474577,48638,2
Kedarnath,901131,637286,1538417,407118,113
Let the Sunshine In,892421,3300169,4192590,39699,2
The Star,40852824,21960150,62812974,9812674,2837
The Cakemaker,875751,411817,1287568,33384,4
Tea With the Dames,889343,2291809,3181152,14777,1
Great Performances at the Met: Nico Muhly: Marnie,849710,15841,865551,639253,669
BANDSTAND: The Broadway Musical on Screen,839554,0,839554,0,0
Schindler's List,833050,148439,981489,566760,1029
Like Arrows,817990,110275,928265,0,0
Beast,800365,943706,1744071,53248,4
Made in India,790628,803536,1594164,581950,193
Pokémon the Movie: The Power of Us,789170,22951618,23740788,255299,989
Border,771930,1405748,2177678,73700,7
1945,1006193,234470,1240663,20365,2
The Party,749827,4848123,5597950,37396,3
How Long Will I Love U,746933,136049786,136796719,204733,23
On Chesil Beach,745971,2589942,3335913,35765,4
The Polar Express,731018,0,731018,165000000,0
The Catcher Was a Spy,725223,228730,953953,114771,46
The Little Stranger,713143,1111759,1824902,401563,474
Mirai,812794,26714167,27526961,63325,69
HBO Boxing: Canelo Alvarez vs. Gennady Golovkin II,707875,0,707875,707875,533
Monster Hunt 2,706153,360976465,361682618,341834,69
Blaze,704955,0,704955,44050,3
Boundaries,703438,52539,755977,29552,5
Jim Henson's Holiday Special with Fraggle Rock and Emmet Otter,695130,0,695130,473802,536
Vox Lux,727119,712420,1439539,155714,6
The Trump Prophecy,671198,0,671198,0,0
The Island,670883,197655467,198326350,263412,40
Bombshell: The Hedy Lamarr Story,820300,271977,1092277,8000,1
Dragon Ball Z: Broly - The Legendary Super Saiyan,658982,0,658982,357322,681
Ponyo,653072,0,653072,281697,726
Lizzie,642157,202629,844786,47580,4
"Love, Gilda",626318,0,626318,189639,82
The Transformers,619597,0,619597,0,0
Foxtrot,618883,737276,1356159,31629,4
The Sound of Music,616171,8221,624392,413497,640
Itzhak,607290,97678,704968,14350,2
The Florida Project,5904366,5066932,10971298,157553,4
The Walking Dead: Wrath/The Walking Dead/Fear the Walking Dead: What's Your Story?/Fear the Walking Dead,605764,0,605764,605764,777
"DCI 2019: Big, Loud & Live 16",603320,0,603320,0,0
The Grateful Dead Meet-Up 2018,600554,0,600554,0,0
Burning,718991,6857354,7576345,26130,2
Marshall,10051659,65157,10116816,3000805,821
The Big Lebowski,582585,10247,592832,330067,624
Pick of the Litter,578717,184971,763688,16519,2
Husband Material,567417,449128,1016545,292439,99
The Riot and the Dance,316103,0,316103,0,0
Loveless,566356,3359636,3925992,30222,3
The Cat Returns,563718,0,563718,254402,721
The Ex-File 3: The Return of The Exes,838959,306753468,307592427,125291,21
The Room,549602,22738,572340,0,0
A Cool Fish,551876,117601259,118153135,71187,15
The Children Act,547750,17149044,17696794,76108,23
Dragon Ball Z: Bardock - The Father of Goku/Dragon Ball Z: Fusion Reborn,540707,0,540707,288095,691
Anna and the Apocalypse,545597,124833,670430,52588,5
Fireworks,525280,25147126,25672406,138014,10
Castle in the Sky,523664,33877,557541,197172,645
Grave of the Fireflies,516962,0,516962,158101,715
The Sandlot,516130,0,516130,263582,410
Bullitt,511350,0,511350,408627,586
Die Hard,510241,110284,620525,321704,687
The Spy Gone North,500803,38343706,38844509,43348,2
Monsters and Men,500101,10866,510967,118697,18
Bilal: A New Breed of Hero,490973,85832,576805,309951,300
The Great Battle,472166,41037114,41509280,123983,30
The Happy Prince,466440,2155552,2621992,38886,8
Puffs: Filmed Live Off Broadway,464483,0,464483,232863,606
Final Portrait,461972,1215863,1677835,25472,3
Scotty and the Secret History of Hollywood,461689,0,461689,28144,1
South Pacific,458000,0,458000,258350,683
Condorito: The Movie,447719,7983475,8431194,248456,153
Perfect Blue,446062,4532,450594,19020,491
Porco Rosso,443059,0,443059,156270,734
Loving Vincent,6735118,35452547,42187665,23180,1
DCI 2018 Tour Premeire,434008,0,434008,0,0
Frankenstein,417783,0,417783,0,0
Cirque du Soleil in Cinema: KURIOS - Cabinet of Curiosities,413039,9721,422760,0,0
A Bag of Marbles,411318,10487680,10898998,14420,4
"The Night Is Short, Walk on Girl",406490,3471718,3878208,18302,10
The Philadelphia Story,404524,0,404524,258994,630
The Oath,401463,0,401463,29077,10
We the Animals,400961,33782,434743,63357,3
The Gospel According to André,400713,53837,454550,47802,4
Leaning Into The Wind,400530,51842,452372,24840,5
Blade Runner 2049,92054159,167185499,259239658,32753122,4058
West Side Story,398670,0,398670,207145,616
Space Mutiny,397887,0,397887,0,0
Krull,397157,0,397157,95010,507
Vertigo,394212,14348,408560,252880,628
Soorma,390077,6189568,6579645,168354,50
Hubble 3D,52522904,21726825,74249729,413477,39
Attack on Titan: Smoke Signal,377334,0,377334,0,0
Oh Lucy!,375391,224754,600145,14569,3
Grace Jones: Bloodlight and Bami,375208,257186,632394,56171,3
Jurassic Park,374238,0,374238,213743,532
Pom Poko,372405,0,372405,107909,733
Believer,365639,38681514,39047153,146630,32
Mountain,365412,1764477,2129889,6067,1
Kusama: Infinity,360931,197121,558052,30998,2
Jane and Emma,380030,0,380030,84512,21
Get Out,176040665,79367304,255407969,33377060,2781
Suicide the Ripple Effect,347468,0,347468,2600,1
Faces Places,953717,3044733,3998450,31006,5
Sailor Moon R: The Movie: The Promise of the Rose/Sailor Moon S: The Movie - Hearts in Ice,335697,0,335697,173199,526
Russ Taff: I Still Believe,334983,0,334983,0,0
Shine,333388,0,333388,205842,609
Hichki,330279,25724943,26055222,330279,73
Flower,328188,52365,380553,48919,3
The Bolshoi Ballet: Live From Moscow - The Nutcracker,323928,0,323928,323928,360
The Opera House,320079,5156,325235,191466,604
Under the Sea 3D,36262926,19639698,55902624,661185,49
The Bolshoi Ballet: Live From Moscow - Romeo and Juliet,313088,0,313088,256025,361
MET Opera: Magic Flute,307686,0,307686,307686,647
Damsel,305136,18099,323235,20291,3
Showtime Championship Boxing: Deontay Wilder vs. Tyson Fury,304482,0,304482,304482,486
The Bolshoi Ballet: Live From Moscow - Giselle,302681,0,302681,244588,357
In the Fade,321011,4783980,5104991,10455,3
Sunset Blvd.,299645,0,299645,169067,628
More Than Funny,290498,0,290498,0,0
Son of Bigfoot,289308,46756973,47046281,0,0
Andy Irons: Kissed by God,285933,144460,430393,0,0
Golden Job,285795,47002056,47287851,121391,34
But Deliver Us from Evil,285169,0,285169,99541,247
Disney's Newsies: The Broadway Musical!,282429,0,282429,122524,647
Science Fair,276195,1143,277338,11231,1
Kings,274635,635634,910269,163289,215
The Endless,272020,684405,956425,9083,1
Doctor Who,264629,0,264629,0,0
Detective Dee: The Four Heavenly Kings,262963,89777808,90040771,126929,31
Eating You Alive,260534,0,260534,0,0
What They Had,260136,273443,533579,17683,4
The King,259291,14310,273601,29050,2
Across the Universe,258618,0,258618,118217,439
Big,258507,0,258507,141578,689
The Square,1502347,7991444,9493791,74233,4
Back to Burgundy,257610,11368274,11625884,15157,5
London Fields,252676,234744,487420,168575,613
Best F(r)iends: Volume 1,252410,37654,290064,131671,409
Batti Gul Meter Chalu,249539,386330,635869,153847,64
The Fireflies Are Gone,245006,0,245006,51119,25
RWBY: Argus Limited,238379,0,238379,0,0
Generation Wealth,237709,50000,287709,35834,4
Alien Intrusion: Unmasking a Deception,237411,0,237411,0,0
Skate Kitchen,236799,50508,287307,18065,1
Happy End,301718,2309076,2610794,23091,3
Hamlet,235229,4395489,4630718,0,0
Superman,233585,0,233585,102223,394
Youth,1891956,225199334,227091290,338604,30
Bishôjo senshi Sailor Moon Super S Special,231434,0,231434,109707,520
Borg vs. McEnroe,231346,3198819,3430165,52625,51
Matangi/Maya/M.I.A,230808,238681,469489,43573,2
MFKZ,229423,232301,461724,6094,436
Little Pink House,220948,0,220948,68507,9
Mazinger Z: INFINITY,220682,4591689,4812371,137451,482
Fragments of Truth,219342,0,219342,0,0
A Bad Moms Christmas,72110659,58449769,130560428,16759161,3615
Dark Money,217932,0,217932,8100,1
Getting Grace,217812,0,217812,103831,60
The Producers,216807,46470,263277,120975,629
The Treasure of the Sierra Madre,215295,0,215295,144074,631
Jane,1723379,197842,1921221,58348,3
Agent Mr. Chan,208351,0,208351,62234,10
The Dating Project,208100,0,208100,0,0
The Guilty,207140,4390911,4598051,60050,29
Default,203775,27490268,27694043,50011,19
Keep the Change,202788,0,202788,12445,1
The Bolshoi Ballet: Live From Moscow - Coppélia,202217,0,202217,202217,360
Zama,200600,289092,489692,26123,3
Gemini,200340,0,200340,32980,4
Gauguin: Voyage to Tahiti,200140,3189182,3389322,35994,6
Rebel Without a Cause,199963,0,199963,116668,658
Have It All -The Movie,197142,0,197142,0,0
Fate/Stay Night: Heaven's Feel - I. Presage Flower,193833,17229102,17422935,0,0
The Final Year,191900,70386,262286,67971,35
Studio 54,199767,27295,227062,14909,1
The Bolshoi Ballet: Live From Moscow - Don Quixote,187946,0,187946,187824,358
The Monkey King 3,187074,114897502,115084576,95577,34
Goldbuster,186135,57442157,57628292,79180,24
Summer 1993,185903,1797246,1983149,21307,4
Owaranai hito: Miyazaki Hayao,187320,0,187320,10238,4
Maquia: When the Promised Flower Blooms,185699,1777876,1963575,71472,157
Madeline's Madeline,185576,11733,197309,18009,1
National Theatre Live: King Lear,185305,0,185305,0,0
Cobra Kai Premiere Event feat. The Karate Kid,185082,0,185082,0,0
Island of Lemurs: Madagascar,11272213,2794321,14066534,188307,37
Karwaan,182009,354516,536525,98460,58
Born to Be Wild,25978556,15665919,41644475,871478,206
Last Letter,180946,11653676,11834622,80485,18
The Accidental Detective 2: In Action,179045,24064780,24243825,47367,11
BuyBust,178471,45249,223720,77955,25
The Guardians,177331,3990277,4167608,7479,1
The Bolshoi Ballet: Live From Moscow - The Flames of Paris,175922,0,175922,175922,360
Always at The Carlyle,174251,0,174251,9239,1
Great Performances at the Met: Puccini: Turandot,172627,46992,219619,0,0
The Bolshoi Ballet: Live From Moscow - La Sylphide,171177,0,171177,168718,355
The House That Jack Built,170113,1763001,1933114,0,0
Luis and the Aliens,169710,12458019,12627729,0,0
The Bolshoi Ballet: Live From Moscow - The Lady of the Camellias,167991,0,167991,167991,358
Rampant,167937,12191636,12359573,18326,2
Double Lover,167581,4844842,5012423,62995,50
Is Genesis History?,166763,0,166763,0,0
Boom for Real: The Late Teenage Years of Jean-Michel Basquiat,166616,28901,195517,22717,2
Far From the Tree,166018,0,166018,19885,2
Only the Brave,18343983,8007339,26351322,6002665,2577
Journey's End,161796,809013,970809,11798,2
National Theatre Live: The Curious Incident of the Dog in the Night-Time,160381,0,160381,0,0
Silencio,158723,179873,338596,90480,348
Cold War,4580048,15715994,20296042,54353,3
"Buttons, A New Musical Film",151983,0,151983,151972,543
Eating Animals,149614,4379,153993,34524,2
Ghost Stories,148747,3982611,4131358,11972,1
Bad Reputation,148568,5622,154190,130675,196
Museo,148505,611121,759626,16554,1
Night of the Living Dead,147423,0,147423,0,0
The Little Mermaid,147175,2463567,2610742,85505,82
Mr. Smith Goes to Washington,144738,0,144738,83205,577
Swing Kids,222001,10175407,10397408,43952,15
Best F(r)iends Volume Two,141524,0,141524,69297,366
Rudy,131200,0,131200,85349,656
Great Performances at the Met: Puccini: Madama Butterfly,129730,0,129730,0,0
Great Performances at the Met: Tchaikovsky: Eugene Onegin,129498,0,129498,0,0
Great Performances at the Met: Verdi: Il Trovatore,129393,0,129393,0,0
Support the Girls,129124,10426,139550,51167,33
Sleepless in Seattle,127281,0,127281,73560,419
Monster Family,127259,27762849,27890108,576,10
The Young Karl Marx,125659,4744714,4870373,26097,3
Bel Canto,125569,224695,350264,12421,2
'85: The Greatest Team in Football History,124573,0,124573,0,0
Destroyer,1533324,4047616,5580940,55347,3
Yu-Gi-Oh!: The Movie - Pyramid of Light,121688,0,121688,68833,556
Geostorm,33700160,187900000,221600160,13707376,3246
Love After Love,121098,7504,128602,11290,1
Five Seasons: The Gardens of Piet Oudolf,119223,11096,130319,7525,3
Till The End Of The World,118660,36895073,37013733,57713,27
The Great Buster,118344,7463,125807,7107,2
Bisbee '17,117470,0,117470,6650,1
Ryuichi Sakamoto: Coda,117460,842752,960212,12827,1
George Takei's Allegiance,117162,0,117162,0,0
Capernaum,1661096,62752082,64413178,24988,3
Wings of Desire,123830,0,123830,12885,1
Gonjiam: Haunted Asylum,115252,20926698,21041950,19017,2
Mantra: Sounds Into Silence,115013,20671,135684,0,0
Nostalgia,114603,0,114603,15955,3
Bodied,113956,0,113956,53000,14
Hymn: Sarah Brightman In Concert,113274,11433,124707,0,0
A Boy. A Girl. A Dream.,112552,0,112552,67760,61
The Dawn Wall,112191,0,112191,21615,2
A Chance in the World,112007,0,112007,0,0
The World Before Your Feet,268644,0,268644,22482,2
"Roman J. Israel, Esq.",11962778,1063082,13025860,61999,4
Amazing Grace,4450456,3345656,7796112,57353,3
The Negotiation,110986,15118207,15229193,14273,2
Lu Over the Wall,109857,51396,161253,60773,97
The Captain,109226,1087443,1196669,7568,1
Mary Shelley,108900,1987700,2096600,12570,2
Deep Sea,46412757,51818148,98230905,700213,43
National Theatre Live: Julius Caesar,107057,0,107057,0,0
"Love, Cecil",106057,1883,107940,9331,1
In Between,107977,1571975,1679952,5888,2
Never Heard,105271,0,105271,0,0
Sweet Country,104297,1743396,1847693,8895,2
Namaste England,104156,175778,279934,67612,71
Detective K: Secret of the Living Dead,104013,18499463,18603476,30288,9
Memoir of War,103636,2877346,2980982,11653,2
Happy Phirr Bhag Jayegi,103385,314284,417669,72376,44
Ismael's Ghosts,102510,2973052,3075562,19158,2
Revenge,102091,835964,938055,45924,37
Andrei Rublev,102021,0,102021,12807,2
Unstoppable,101417,11743930,11845347,42133,22
The Man Who Invented Christmas,5676486,2419521,8096007,1357129,626
All About Nina,100335,0,100335,26468,4
Filmworker,102609,10219,112828,7984,1
Meow Wolf: Origin Story,99488,0,99488,0,0
Big Sonia,212471,0,212471,4398,1
National Theatre Live: Macbeth,97857,0,97857,0,0
Champion,97472,8877075,8974547,17095,2
Wonder Wheel,1404061,14485063,15889124,125570,5
Godspeed: The Race Across America,96690,0,96690,0,0
El Angel,109608,5495072,5604680,23348,2
Golden Slumber,94450,10638876,10733326,0,0
Let the Corpses Tan,93409,0,93409,11918,3
Reign of Judges: Title of Liberty - Concept Short,93224,5184,98408,0,0
The Breadwinner,312381,50926,363307,17395,3
BANDSTAND: The Broadway Musical on Screen,91000,0,91000,0,0
John McEnroe: In the Realm of Perfection,90964,23325,114289,7878,1
Running for Grace,89988,0,89988,30597,3
Airpocalypse,105678,18385411,18491089,35363,21
Cat on a Hot Tin Roof,89332,0,89332,0,0
The Third Murder,89315,13322621,13411936,10670,2
Bolshoi Ballet: Swan Lake,88905,253486,342391,0,0
Goldstone,87639,0,87639,1300,1
The Price of Everything,87400,57046,144446,16817,1
Lobster Cop,85693,10287436,10373129,35015,12
Big Brother,85624,21943626,22029250,41225,25
How to Talk to Girls at Parties,84809,300924,385733,12674,2
Stan & Ollie,5470235,18950688,24420923,78104,5
Custody,83882,3706421,3790303,4947,1
National Theatre Live: Antony & Cleopatra,83672,914407,998079,0,0
Claire's Camera,83418,108562,191980,11489,1
Blood Fest,82774,40059,122833,0,0
Doctor Who: The Woman Who Fell to Earth,82698,0,82698,0,0
Godard Mon Amour,82264,1253582,1335846,10994,4
Yuri!!! On Ice,81878,8873,90751,81878,109
Nancy,80115,11885,92000,15056,3
En el séptimo día,79887,0,79887,12793,2
Have a Nice Day,79393,424610,504003,10463,1
The Princess and the Matchmaker,78900,9820117,9899017,20142,3
The Boxcar Children - Surprise Island,78676,0,78676,0,0
Shock and Awe,77980,104435,182415,45856,100
A Breath Away,77987,2764053,2842040,16046,12
93Queen,76056,0,76056,6302,1
The Brawler,75929,62586,138515,47808,19
The Riot Act,75506,0,75506,28840,9
Keys To The Heart,75134,25300732,25375866,9851,2
Tehran Taboo,74758,275128,349886,4962,1
Above and Beyond: NASA's Journey to Tomorrow,74711,0,74711,35490,350
After Auschwitz,73885,0,73885,0,0
Bye Bye Germany,73730,103203,176933,4874,2
The Last Suit,73548,534661,608209,27549,6
"Nico, 1988",73304,10254,83558,12309,2
Becoming Astrid,120486,818280,938766,5361,3
Helicopter Eela,71971,184981,256952,51115,70
Tom of Finland,378296,1398635,1776931,13524,1
Namiya,70814,35280809,35351623,39584,21
The Fog,70421,0,70421,39565,43
Wastelander,70045,0,70045,20768,22
Parchi,69431,7679,77110,34437,39
The House That Jack Built,87993,2180969,2268962,34273,32
Outside In,68492,0,68492,14136,9
Where Hands Touch,67743,60526,128269,67743,103
Under the Tree,67596,877395,944991,13617,3
Making the Five Heartbeats,67415,0,67415,0,0
The Doctor from India,67136,0,67136,2442,1
Chef Flynn,68407,1135,69542,7509,1
"3100, Run and Become",65524,1265,66789,0,0
Beuys,65410,21041,86451,9084,2
Feng Shui,64147,15638155,15702302,9644,2
Liz and the Blue Bird,63204,663250,726454,0,0
The Gardener,62734,0,62734,6298,1
Never Goin' Back,61271,0,61271,10322,2
Walk With Me,726726,879979,1606705,9932,1
Viper Club,60607,0,60607,14180,3
Where Is Kyra?,59717,15104,74821,7000,1
Bomb City,59329,0,59329,31005,17
Digimon Adventure tri. Part 4: Loss,59114,0,59114,0,0
"Westwood: Punk, Icon, Activist",58979,327877,386856,4450,1
A Kid Like Jake,58403,2381,60784,8936,1
My Friend Dahmer,1361611,75140,1436751,35545,4
In Search of Greatness,58090,0,58090,32952,16
Cynthia,58177,0,58177,30660,21
Woman Walks Ahead,57528,23384,80912,6863,2
Black '47,57520,2015543,2073063,8600,1
"Monrovia, Indiana",63944,652,64596,5172,1
Bhavesh Joshi Superhero,57376,24416,81792,42579,46
Ramen Heads,57345,0,57345,7085,2
Django,56556,3820318,3876874,11722,4
American Dream: Detroit,55092,0,55092,0,0
DAZN Boxing: Canelo Alvarez vs. Rocky Fielding,54916,0,54916,54916,368
Digimon Adventure tri. Part 6: Future,54324,0,54324,0,0
The Great Silence,53074,0,53074,8755,1
Twiceland,52874,133204,186078,0,0
Digimon Adventure tri. Part 5: Coexistence,52339,329780,382119,0,0
Before We Vanish,52087,396742,448829,8370,2
The Snowman Trek,51743,0,51743,0,0
Wanda,51713,0,51713,10679,1
I Am Not A Witch,50868,131594,182462,8252,2
The Royal Wedding: Prince Harry and Meghan Markle,50264,0,50264,50264,194
Jumanji/Jumanji: Welcome to the Jungle,49381,0,49381,32264,335
Hal,48698,347,49045,5150,1
The China Hustle,48650,0,48650,25791,20
350 Days - Legends. Champions. Survivors,47526,0,47526,0,0
Bigger,46382,3615,49997,31477,61
Racer and the Jailbird,46337,353689,400026,2513,2
Summer in the Forest,45542,22201,67743,8366,1
Wait for Your Laugh,73585,0,73585,14946,2
Rodin,44261,128358,172619,0,0
The Sacrifice,61018,0,61018,4696,1
What Will People Say,44156,2146975,2191131,4024,1
Garry Winogrand: All Things are Photographable,44002,0,44002,9058,1
Hitler's Hollywood,43766,0,43766,8634,1
Antonio Lopez 1970: Sex Fashion & Disco,43169,29953,73122,7167,1
Indian Horse,2097362,0,2097362,0,0
First We Take Brooklyn,42812,0,42812,15845,5
A Ciambra,41934,62874,104808,6330,1
Golden Exits,41888,0,41888,11719,1
Western,41072,114143,155215,6688,1
Humor Me,40099,0,40099,3342,1
Submission,39985,4084,44069,0,0
Mamma Mia!,39601,15567,55168,23376,243
Araby,38399,0,38399,8668,1
Gray Matter,38034,0,38034,14064,12
The Heart of Nuba,37788,0,37788,4016,1
Oolong Courtyard: KungFu School,37727,19091288,19129015,19065,10
Krystal,37516,0,37516,0,0
"Hale County This Morning, This Evening",112282,0,112282,8640,2
The Other Side of Hope,183943,4099030,4282973,15495,3
Girls vs Gangsters,37115,10228704,10265819,15044,4
Breath,37108,3285371,3322479,5258,1
Small Group,37058,0,37058,26579,10
Searching for Ingmar Bergman,36686,28056,64742,5996,1
Mind Game,36613,0,36613,5609,7
Divide and Conquer,38510,0,38510,18833,15
Le Corbeau,36089,0,36089,6452,1
The House of Tomorrow,35821,0,35821,6652,8
The Big Bad Fox and Other Tales,35787,9386340,9422127,0,0
The Road Movie,35757,0,35757,17175,19
For Those Who Don't Read Me,36506,0,36506,9263,5
Just Getting Started,6069605,1564417,7634022,3201459,2161
24 Frames,34482,2563,37045,8101,1
Space Station 3D,93383953,34979928,128363881,489488,24
Holy Hell,34366,0,34366,21504,4
Maui,33953,0,33953,0,0
"No Date, No Signature",36444,70924,107368,4993,3
Sollers Point,32608,0,32608,10618,1
BPM (Beats Per Minute),125189,7579180,7704369,8566,2
Liyana,44045,0,44045,2160,1
Goodland,32140,0,32140,17621,2
Moynihan,31970,0,31970,4416,1
Saving Brinton,56218,0,56218,2690,1
Good Manners,31177,4537,35714,2476,1
Poor Boy,31031,0,31031,10920,4
Galapagos,18630372,10718800,29349172,0,0
Cold Water,30209,0,30209,5110,1
The Desert Bride,30110,175240,205350,2127,2
Desolation,18490,0,18490,11320,2
Memories of Underdevelopment,29647,0,29647,8244,1
Same Kind of Different as Me,6423605,0,6423605,2591985,1362
The Mercy,29538,276667,306205,0,0
Charm City,29335,0,29335,10511,1
Restoring Tomorrow,28556,0,28556,0,0
The Apparition,28293,3534500,3562793,9830,7
On Her Shoulders,28288,11857,40145,4374,1
Quai des Orfèvres,28013,0,28013,7125,1
The Amendment,27961,0,27961,0,0
Horn from the Heart: The Paul Butterfield Story,58597,0,58597,3086,1
Senso,27723,0,27723,3984,1
The Cured,26630,297146,323776,4875,3
Milford Graves Full Mantis,26566,0,26566,7407,1
Belle de Jour,26331,13220,39551,6462,1
The Misandrists,26123,0,26123,3278,1
Ridge Runners,26019,0,26019,8015,7
Jet Trash,26002,0,26002,4914,2
Birdboy: The Forgotten Children,38786,13580,52366,5849,4
Let There Be Light,7233471,0,7233471,1729535,373
No Intenso Agora,24955,13268,38223,5565,1
An Elephant's Journey,24844,0,24844,0,0
The Day After,24746,141276,166022,3727,1
Night of 7 Years,24281,3692539,3716820,13669,4
Elliot the Littlest Reindeer,24262,1117925,1142187,22056,105
Death House,23833,0,23833,10140,1
Swimming with Men,24708,1353040,1377748,10336,31
Vazante,23884,1207,25091,3489,1
The Divine Order,76277,118804,195081,0,0
Letter from Masanjia,23481,0,23481,8295,2
Take Point,112386,12795646,12908032,21189,2
The Atomic Cafe,22293,0,22293,4098,1
The Judge,22257,870,23127,0,0
Winning Formula,22189,0,22189,4505,5
The Workshop,22061,977995,1000056,2860,1
Loving Pablo,22017,17513945,17535962,16564,15
The Female Brain,21786,0,21786,6886,2
A Paris Education,21598,89599,111197,3467,1
Half the Picture,21589,0,21589,6581,1
Primal Rage: The Legend of Konga,21497,51886,73383,0,0
Journey to the South Pacific,7653913,7340963,14994876,8137,1
Ganja & Hess,21197,0,21197,3406,1
The Happys,21108,0,21108,7707,2
Ava,20940,0,20940,2996,1
Did You Wonder Who Fired the Gun?,20765,0,20765,5725,3
The Tag Along: Devil Fish,20726,133169,153895,10974,8
Ice Dragon: Legend of the Blue Daisies,20549,0,20549,11984,228
The Devil and Father Amorth,20449,0,20449,7814,8
Izzy Gets the F*ck Across Town,20208,0,20208,10559,15
The Last Resort,158646,0,158646,1844,1
Apocalypsis,20052,0,20052,3945,1
Eight Hours Don't Make a Day,19987,0,19987,5880,1
"One Sings, the Other Doesn't",19919,0,19919,6700,1
Active Measures,19862,0,19862,9509,2
Freak Show,19696,961,20657,4809,1
God's Own Country,335609,2224330,2559939,17768,2
To the Arctic 3D,14560838,9134550,23695388,270228,50
Who We Are Now,19128,0,19128,5188,1
November,19084,0,19084,3354,1
Anything,19037,3500,22537,4110,3
Crime + Punishment,18644,0,18644,8787,3
Mrs. Hyde,18627,759515,778142,5943,1
Maquia: When the Promised Flower Blooms,18539,2551388,2569927,6100,13
Allegiance to Broadway,18527,0,18527,0,0
Gabriel and the Mountain,18415,487354,505769,4963,2
306 Hollywood,18399,0,18399,8150,1
Marlina the Murderer in Four Acts,17788,8543,26331,3296,1
Batman: Mask of the Phantasm,17813,0,17813,0,0
King of Hearts,17646,484,18130,3443,1
The Chronicle of Anna Magdalena Bach,17527,0,17527,3453,2
"A Bread Factory, Part One/A Bread Factory, Part Two",17325,0,17325,5847,2
Revival,17252,0,17252,0,0
Heading Home: The Tale of Team Israel,207533,0,207533,12678,1
Life and Nothing More,24358,16223,40581,6536,6
Haikara-San: Here Comes Miss Modern,16572,0,16572,6748,51
Just One Drop,60078,0,60078,0,0
"Intent to Destroy: Death, Denial & Depiction",18340,0,18340,0,0
Out on Stage,15623,0,15623,0,0
Bob le Flambeur,15586,0,15586,4623,1
When You Read This Letter,15552,0,15552,5166,1
People's Republic of Desire,15241,0,15241,0,0
Trust Machine: The Story of Blockchain,14905,0,14905,7424,1
The Lucky Man,25015,0,25015,4956,3
The Charmer,26167,80212,106379,4128,1
Thelma,147391,1316336,1463727,10841,1
A Prayer Before Dawn,14453,944430,958883,14453,13
The Last Movie Star,14410,0,14410,3780,2
Narcissister Organ Player,15334,0,15334,1983,1
Koroshiya 1,20285,0,20285,2750,1
Detour,16172,0,16172,5127,1
Chasing the Blues,14030,0,14030,9949,9
The Escape,14018,376863,390881,0,0
Weed the People,13926,0,13926,4279,1
Here and Now,13892,47379,61271,8090,51
Stavisky...,13793,0,13793,4734,1
PGS: Intuition Is Your Personal Guidance System,35423,0,35423,0,0
The Boy Downstairs,13638,60350,73988,5995,1
Shed Skin Papa,13331,1264734,1278065,7950,8
Our Blood is Wine,13210,0,13210,1540,2
Novitiate,580346,0,580346,22724,3
Like Me,12965,0,12965,5064,3
How Viktor 'The Garlic' Took Alexey 'The Stud' to the Nursing Home,12954,99117,112071,2634,8
"Lou Andreas-Salomé, The Audacity to be Free",12875,266107,278982,5060,1
American Socialist: The Life and Times of Eugene Victor Debs,12609,0,12609,2823,1
My Art,12554,0,12554,5538,1
American Chaos,12368,0,12368,7616,26
Head Full of Honey,12350,126494,138844,8715,4
Let Yourself Go,12189,2128001,2140190,8128,8
Quest,47807,2215,50022,6591,1
The Most Unknown,12119,0,12119,2905,1
Return of the Hero,37108,7325622,7362730,761,1
Minding the Gap,11998,78330,90328,6812,4
The Last Race,11947,0,11947,2437,3
Les Parents Terribles,11818,0,11818,5332,1
Victoria & Abdul,22245070,44313395,66558465,158845,4
Summer '03,11746,0,11746,4174,2
Hannah,11700,134625,146325,11700,2
Tyrel,21456,0,21456,6059,5
This is Our Land,11567,4615,16182,2442,1
Souvenir,11411,348387,359798,2267,1
Rendezvous in July,11321,0,11321,6080,1
The Public Image is Rotten,11293,3171,14464,8052,1
Bullitt County,11257,0,11257,6511,9
The Assassin's Code,11218,42722,53940,11218,12
Wedding Party 2,11140,98319,109459,4905,2
The Samuel Project,161565,0,161565,11087,2
Embrace: The Documentary,629126,526137,1155263,0,0
Sicilian Ghost Story,15285,189607,204892,4324,1
Class Rank,10452,0,10452,0,0
Mama Africa,10430,0,10430,3495,1
The Advocates,10402,0,10402,4355,1
Dying to Know: Ram Dass & Timothy Leary,16397,0,16397,0,0
Heavy Trip,10153,20198,30351,5419,16
Furious,9996,10423263,10433259,6964,15
River Runs Red,9893,51896,61789,6349,20
Please Stand By,9868,396864,406732,4090,5
The Quest of Alain Ducasse,9627,0,9627,2711,1
Strangers on the Earth,9518,0,9518,3768,1
That Summer,34556,10103,44659,5977,1
The Crime of Monsieur Lange,36438,1564,38002,9633,1
El Mar La Mar,9065,0,9065,3375,1
Step Up: High Water,9005,0,9005,0,0
Zoo Wars,8998,0,8998,8998,12
Survivors Guide To Prison,8982,0,8982,8982,4
Blood Feast,8708,0,8708,4046,1
Summer of '67,8941,0,8941,5400,1
Beauty and the Dogs,8915,158808,167723,3055,2
Un traductor,13509,64566,78075,4412,1
The Clovehitch Killer,8208,159786,167994,5175,26
Spiral,8190,0,8190,3258,2
Dark River,7714,231468,239182,4246,2
Legend of the Mountain,7640,0,7640,0,0
Spettacolo,32494,0,32494,4403,2
The Lodgers,7362,909365,916727,5053,17
Shoah: Four Sisters,7323,0,7323,2840,1
Tall: The American Skyscraper and Louis Sullivan,7216,0,7216,7216,1
Painless,7082,0,7082,2958,2
Defining Hope,15788,0,15788,0,0
In Echo Park,7072,0,7072,4222,2
This is Congo,7051,1854,8905,3690,1
In the Land of Pomegranates,7014,0,7014,3072,1
On the Beach at Night Alone,37489,391670,429159,7594,1
Duck Butter,6877,0,6877,2797,2
Ex Libris: New York Public Library,158192,40047,198239,10926,1
Calling All Earthlings,6756,0,6756,0,0
A Whale of a Tale,6747,0,6747,0,0
An Evening with Beverly Luff Linn,6701,16814,23515,5212,16
School of Life,6300,14874197,14880497,0,0
Of Fathers and Sons,12579,0,12579,340,1
The Quake,6235,13831059,13837294,3256,7
One Last Thing,6232,0,6232,0,0
Women Like Us,25859,0,25859,0,0
Chavela,148666,124176,272842,22453,4
I Am MLK Jr.,5918,0,5918,0,0
Aida's Secrets,98468,0,98468,5665,1
Bill Nye: Science Guy,74909,0,74909,7005,1
Dolores,555309,0,555309,13534,1
Are We Not Cats,5518,0,5518,3983,2
Cuban Food Stories,5434,0,5434,3032,1
"Distant Voices, Still Lives",5234,28067,33301,2395,1
Postcards from London,5312,10236,15548,2686,1
In Searching,5210,0,5210,3090,2
12 Days,5204,716845,722049,923,1
Intersection,5116,0,5116,1940,2
Notes on an Appearance,5065,0,5065,2239,1
The Texture of Falling,5010,0,5010,676,1
Social Animals,5007,0,5007,2505,75
An L.A. Minute,5004,0,5004,2791,3
Edward II,4826,6229,11055,1701,1
Status Update,4764,411414,416178,2205,75
Wonderstruck,1060377,2225539,3285916,65882,4
The Other Side of Everything,4685,0,4685,315,1
The Long Dumb Road,4667,0,4667,4667,1
Kangaroo,4547,8079,12626,2282,2
Kickboxer: Retaliation,4537,97153,101690,3061,10
Never Look Away,1304042,3801402,5105444,0,0
Weightless,4461,69,4530,2515,2
The Peacemaker,4400,0,4400,4400,1
Miss Kiet's Children,9384,0,9384,2035,2
Stella's Last Weekend,4215,0,4215,2375,2
The Party's Just Beginning,4145,226,4371,2770,10
Frank and Ava,18829,0,18829,3080,1
Armed,3948,0,3948,2227,10
American Dresser,3895,0,3895,2211,11
Nocturama,30157,291611,321768,5402,3
Porto,15126,75723,90849,2090,1
Cocote,3815,409,4224,1436,1
Félicité,12433,253062,265495,1713,1
Nelly,3751,0,3751,1304,1
The Family,3696,0,3696,2030,1
Fourplay,3550,0,3550,3550,2
Brimstone & Glory,32059,3977,36036,2125,1
The Citizen,3495,0,3495,0,0
Under The Wire,3429,20468,23897,2271,2
Followers,3350,0,3350,0,0
Tom of Finland,3314,12169,15483,1006,1
Song Of Granite,16182,5167,21349,3096,1
At First Light,3292,23046,26338,274,5
Game Changers,3142,0,3142,3142,1
Hot to Trot,3133,0,3133,3133,1
Over the Limit,3243,0,3243,1402,1
Living Proof,9512,0,9512,0,0
The Paris Opera,55482,725557,781039,7709,4
Nana,2784,0,2784,1240,1
Straight Into a Storm,2684,0,2684,1964,1
ACORN and the Firestorm,2621,0,2621,2621,1
Kingsman: The Golden Circle,100234838,310667824,410902662,39023010,4003
The Pact,2488,1853159,1855647,1453,10
The Second Time Around,3837,0,3837,0,0
Charged: The Eduardo Garcia Story,15920,0,15920,0,0
The Swan,2367,60349,62716,898,1
Shadowman,13498,0,13498,4113,1
Forever,31502,0,31502,5202,1
10x10,2263,65997,68260,1430,10
A Wizard's Tale,2150,5485111,5487261,1593,10
Escapes,17778,0,17778,1339,1
The Cage Fighter,3392,0,3392,1204,2
In Search of Fellini,12772,12497,25269,10796,3
Signature Move,31551,0,31551,18935,1
Last Men in Aleppo,14637,0,14637,1505,1
From the East,8540,0,8540,564,1
West Of The Jordan River,1926,0,1926,1047,1
The Fencer,95952,503585,599537,5572,2
Permanent,12847,0,12847,5722,8
Finding Happiness,1841,0,1841,0,0
The Thousand Faces of Dunjia,124187,46139050,46263237,57837,27
The Lost Village,1780,0,1780,840,1
An Actor Prepares,1743,4148,5891,933,25
Tournament,4942,0,4942,0,0
That Way Madness Lies...,1447,0,1447,579,2
Marrowbone,1377,12293554,12294931,624,7
Beauty and the Beholder,1368,0,1368,1352,1
Columbus,1017107,75970,1093077,26820,2
I Still See You,1359,1619278,1620637,815,10
"Hare Krishna! The Mantra, the Movement and the Swami Who Started It",19278,11102,30380,0,0
Guy,1319,1256618,1257937,1319,2
Altered Perception,1259,0,1259,0,0
Two Men Went to War,1227,0,1227,185,1
Under the Turban,1190,0,1190,0,0
Henchmen,1469,0,1469,580,3
Bronx Gothic,27151,0,27151,4696,1
Invisible Hands,1034,0,1034,456,1
Gangsterdam,954,2696568,2697522,0,0
30 Years of Garbage: The Garbage Pail Kids Story,27739,0,27739,5030,2
BOSTON: An American Running Story,19499,0,19499,0,0
Bad Lucky Goat,5088,0,5088,170,3
The Breadwinner,834,2426073,2426907,834,1
33 & Beyond: The Royal Art of Freemasonry,16533,0,16533,0,0
TVTV: Video Revolutionaries,812,0,812,556,1
The Ghosts of Johnson Woods,3000,0,3000,0,0
The Lovely Month of May,55038,0,55038,10662,3
To Die Is Hard,5129,0,5129,112,1
Higher Power,528,0,528,299,3
Nostalgia for the Light,163962,13672,177634,5664,1
The Legend of Hallowaiian,451,53287,53738,0,0
Midget Zombie Takeover,11006,0,11006,2755,1
Rat Film,35195,0,35195,7793,2
Around India with a Movie Camera,10389,1179,11568,183,1
Far from Vietnam,8132,0,8132,1125,1
Tosca's Kiss,18236,0,18236,418,1
A Man Vanishes,6201,0,6201,1576,2
Realms,147,22296,22443,108,3
Avengers: Endgame,858373000,1939427564,2797800564,357115007,4662
The Lion King,543638043,1113305351,1656943394,191770759,4725
Toy Story 4,434038008,639356585,1073394593,120908065,4575
Frozen II,477373578,972653355,1450026933,130263358,4440
Captain Marvel,426829839,701444955,1128274794,153433423,4310
Star Wars: Episode IX - The Rise of Skywalker,515202542,558941706,1074144248,177383864,4406
Spider-Man: Far from Home,390532085,741395911,1131927996,92579212,4634
Aladdin,355559216,695134737,1050693953,91500929,4476
Joker,335451311,738800000,1074251311,96202337,4374
It Chapter Two,211593228,261500000,473093228,91062152,4570
Jumanji: The Next Level,316831246,479744747,796575993,59251543,4227
Us,175084580,80100000,255184580,71117625,3741
Fast & Furious Presents: Hobbs & Shaw,173956935,585100000,759056935,60038950,4253
John Wick: Chapter 3 - Parabellum,171015687,155694040,326709727,56818067,3850
How to Train Your Dragon: The Hidden World,160799505,361000000,521799505,55022245,4259
The Secret Life of Pets 2,158874395,271176898,430051293,46652680,4561
Pokémon Detective Pikachu,144105346,288900000,433005346,54365242,4202
Once Upon a Time... in Hollywood,142502728,231840898,374343626,41082018,3659
Shazam!,140371656,225600000,365971656,53505326,4217
Aquaman,335061807,813400000,1148461807,67873522,4125
Knives Out,165363234,143869563,309232797,26769548,3461
Dumbo,114766307,238518314,353284621,45990748,4259
Maleficent: Mistress of Evil,113929605,377800484,491730089,36948713,3790
Glass,111048468,135950571,246999039,40328920,3841
Godzilla: King of the Monsters,110500138,276100000,386600138,47776293,4108
The Upside,108252517,17600000,125852517,20355000,3080
Ford v Ferrari,117624357,107883853,225508210,31474958,3528
The Lego Movie 2: The Second Part,105806508,86500000,192306508,34115335,4303
Hustlers,104963598,52600000,157563598,33181361,3250
The Addams Family,100044905,103000000,203044905,30300007,4007
Downton Abbey,96854135,96095302,192949437,31033665,3079
Rocketman,96368160,98811139,195179299,25725722,3610
Alita: Battle Angel,85710210,319142333,404852543,28525613,3790
Good Boys,83140306,27886684,111026990,21402605,3204
Spider-Man: Into the Spider-Verse,190241310,185299521,375540831,35363376,3813
Men in Black: International,80001807,173888894,253890701,30035838,4224
Annabelle Comes Home,74152591,157100000,231252591,20269723,3613
Yesterday,73286650,79802376,153089026,17010050,2603
A Madea Family Funeral,73257045,1490680,74747725,27062332,2442
Zombieland: Double Tap,73123082,49687317,122810399,26803104,3468
Angel Has Fallen,69030436,77631541,146661977,21380987,3286
Scary Stories to Tell in the Dark,68947075,35598430,104545505,20915346,3135
Mary Poppins Returns,171958438,177579056,349537494,23523121,4090
X-Men: Dark Phoenix,65845974,186597000,252442974,32828348,3721
Terminator: Dark Fate,62253077,198866215,261119292,29033832,4086
Abominable,60716390,120998569,181714959,20612100,4242
Dora and the Lost City of Gold,60477943,59204692,119682635,17431588,3735
Escape Room,57005601,98706476,155712077,18238172,2717
A Beautiful Day in the Neighborhood,61704055,6056822,67760877,13251238,3235
Midway,56846802,68801710,125648512,17897419,3242
Bumblebee,127195589,340794056,467989645,21654047,3550
The Curse of la Llorona,54733739,68400000,123133739,26347631,3372
Pet Sematary,54724696,58393530,113118226,24502775,3585
What Men Want,54611903,17604391,72216294,18232087,2912
Green Book,85080171,236672485,321752656,320429,25
Ad Astra,50188370,77273502,127461872,19001398,3460
Isn't It Romantic,48791187,0,48791187,14247758,3444
Gemini Man,48546770,124922746,173469516,20552372,3642
Ma,45896028,15209644,61105672,18099805,2808
Five Feet Apart,45729221,45792873,91522094,13190286,2803
Wonder Park,45216793,74342317,119559110,15853646,3838
Rambo: Last Blood,44819352,46671001,91490353,18872919,3618
Playing with Fire,44451847,24179822,68631669,12723781,3125
Harriet,43082155,264862,43347017,11676720,2059
A Dog's Way Home,42004346,38703788,80708134,11251263,3090
The Angry Birds Movie 2,41667116,106124931,147792047,10354073,3869
Little,40860481,8126615,48987096,15405455,2667
Queen & Slim,43808310,3851130,47659440,11890490,1690
Breakthrough,40713082,9731276,50444358,11282333,2824
The Mule,103804407,71000000,174804407,17509431,2588
Crawl,39014193,52527904,91542097,12005210,3170
Little Women,108101214,101000000,209101214,16755310,3308
The Intruder,35419122,5666358,41085480,10855054,2222
The Hustle,35417038,59601562,95018600,13007709,3007
Last Christmas,35150750,86400000,121550750,11441055,3448
Overcomer,34746945,3279158,38026103,8146533,1723
Cold Pursuit,32138862,44280893,76419755,11030233,2630
Doctor Sleep,31581712,40800000,72381712,14114124,3855
Dragon Ball Super: Broly,30712119,84848491,115560610,9816197,1238
Long Shot,30316271,23557538,53873809,9740064,3230
Spies in Disguise,66757013,104859751,171616764,13354798,3502
Child's Play,29208403,15693834,44902237,14094594,3007
Ready or Not,28714231,28901546,57615777,8015590,2855
Happy Death Day 2U,28148130,36452022,64600152,9497665,3207
Vice,47836282,28237206,76073488,7768371,2442
21 Bridges,28539757,21400000,49939757,9261268,2665
Midsommar,27426361,20437004,47863365,6560030,2707
Bohemian Rhapsody,216428042,687227217,903655259,51061119,4000
The Art of Racing in the Rain,26395642,7371145,33766787,8137584,2765
Countdown,25621766,22400000,48021766,8865082,2675
Uncut Gems,50023780,0,50023780,537242,5
Judy,24313888,19314428,43628316,2916548,461
Ralph Breaks the Internet,201091711,328232251,529323962,56237634,4017
Fighting with My Family,22958886,17853033,40811919,138780,4
On the Basis of Sex,24622687,14051063,38673750,686355,33
A Dog's Journey,22782371,52835209,75617580,8030085,3267
Booksmart,22680962,2182490,24863452,6933620,2505
Parasite,53369749,203635438,257005187,393216,3
Stuber,22370452,10020493,32390945,8225384,3050
47 Meters Down: Uncaged,22260900,24522203,46783103,8427265,2853
Black and Blue,22055313,685748,22741061,8376846,2062
Hellboy,21903748,22762387,44666135,12045147,3303
Shaft,21360215,0,21360215,8901419,2952
Jojo Rabbit,33370906,56964119,90335025,349555,5
The Peanut Butter Falcon,20457151,2612047,23069198,204793,17
UglyDolls,20150241,12300000,32450241,8603407,3652
Cats,27166770,46569374,73736144,6619870,3380
Unplanned,19005109,2046806,21051915,6382298,1059
The Favourite,34366783,61551923,95918706,422410,4
Bombshell,31762808,27873715,59636523,319157,4
Richard Jewell,22345542,21400000,43745542,4705265,2502
Charlie's Angels,17803077,55476811,73279888,8351109,3452
The Farewell,17695781,4822083,22517864,355662,4
Brightburn,17300439,15592982,32893421,7845658,2607
The Good Liar,17156058,16700000,33856058,5605051,2439
The Kid Who Would Be King,16790790,15350180,32140970,7173887,3521
Missing Link,16649539,9599930,26249469,5944950,3413
Second Act,39282227,33000000,72282227,6489983,2607
Late Night,15499454,6887101,22386555,246305,4
Miss Bala,15006824,376756,15383580,6864744,2203
The Prodigy,14856291,6293974,21150265,5853061,2530
A Star Is Born,215288866,220900000,436188866,42908051,3686
Poms,13631124,2787094,16418218,5361937,2750
If Beale Street Could Talk,14915773,5680794,20596567,224476,4
They Shall Not Grow Old,17956913,1173098,19130011,0,0
The Kitchen,12180032,3800000,15980032,5527410,2745
After,12138565,57594917,69733482,6002349,2138
Blinded by the Light,11901145,6192355,18093500,4333305,2307
The Lighthouse,10867104,7215488,18082592,427797,8
Dark Waters,11136084,10482001,21618085,102606,4
Greta,10532219,8120888,18653107,4481910,2411
The Best of Enemies,10205616,4197,10209813,4446190,1705
Black Christmas,10429730,8100000,18529730,4240245,2625
Hotel Mumbai,9651611,11663205,21314816,88065,4
Holmes & Watson,30573626,9893344,40466970,7411522,2776
Motherless Brooklyn,9277736,9200000,18477736,3500454,1342
No Manches Frida 2,9270920,17222728,26493648,3831401,472
"Where'd You Go, Bernadette",9198356,1149484,10347840,3462308,2404
Apollo 11,9039891,6302462,15342353,1607040,120
Serenity,8547045,5907577,14454622,4415403,2561
Anna,7743794,23896396,31640190,3600647,2114
Penguins,7699452,0,7699452,2282593,1815
Brittany Runs a Marathon,7189808,252298,7442106,180711,5
Mary Queen of Scots,16468499,30241784,46710283,194777,4
The Dead Don't Die,6563605,8757846,15321451,2540240,613
Jexi,6546159,2406391,8952550,3106730,2332
Run the Race,6424420,0,6424420,2161480,853
Free Solo,17541090,11777771,29318861,294288,4
The Current War: Director's Cut,5979540,6302845,12282385,2633717,1022
Captive State,5958315,2850296,8808611,3131525,2548
The Wandering Earth,5971413,693885286,699856699,1685287,64
Arctic Dogs,5801249,4100918,9902167,2901335,2844
Gloria Bell,5611123,5533883,11145006,145218,5
Gully Boy,5566534,22575461,28141995,2045068,258
Stan & Ollie,5470235,18950688,24420923,78104,5
The Goldfinch,5332621,4600000,9932621,2679027,2542
Don't Let Go,5215062,72949,5288011,2338669,922
The Mustang,5043620,1362196,6405816,71657,4
The Sun Is Also a Star,4950029,1800000,6750029,2511530,2073
Bring The Soul: The Movie,4809800,6584086,11393886,2296491,873
Pavarotti,4600249,3284767,7885016,144032,19
Tolkien,4535154,4554886,9090040,2200537,1495
The Last Black Man in San Francisco,4515719,91298,4607017,235272,7
War,4654000,62525155,67179155,1607627,305
Cold War,4580048,15715994,20296042,54353,3
Menteur,4697364,0,4697364,607229,89
Brian Banks,4376819,0,4376819,2156272,1240
The Biggest Little Farm,4366949,881463,5248412,110492,5
The Grinch,270620950,240975007,511595957,67572855,4141
Amazing Grace,4450456,3345656,7796112,57353,3
Linda Ronstadt: The Sound of My Voice,4252657,0,4252657,113235,7
Uri: The Surgical Strike,4186168,116286,4302454,631146,101
Replicas,4046429,5283646,9330075,2375325,2329
Pain and Glory,4567338,32569736,37137074,152636,4
Ne Zha,3695533,722367938,726063471,1015755,66
Mission Mangal,3659413,2007644,5667057,1365006,263
The Oscar Nominated Short Films 2019: Documentary,3531094,7456,3538550,938455,270
BTS World Tour: Love Yourself in Seoul,3509917,6685843,10195760,2860016,997
The Beach Bum,3502600,1051816,4554416,1763070,1100
Echo in the Canyon,3355324,0,3355324,117651,2
Creed II,115715889,98500000,214215889,35574710,3441
Jay and Silent Bob Reboot,4589490,101758,4691248,93520,1
Maiden,3168978,326263,3495241,46931,6
Simmba,5102129,4744324,9846453,1758576,301
Bharat,2971549,30214434,33185983,1252301,311
Honey Boy,3012615,388362,3400977,301065,4
Friends 25th: The One With The Anniversary,2884827,518579,3403406,1177873,1586
Saaho,2872057,2836465,5708522,1452102,381
Fantastic Beasts: The Crimes of Grindelwald,159555901,495300000,654855901,62163104,4163
Kalank,2729336,15257698,17987034,1276581,320
Tod@s Caen,2670925,6996232,9667157,1098401,371
Everybody Knows,2660165,16515998,19176163,71207,4
Instant Family,67363237,53192964,120556201,14504315,3286
The Art of Self-Defense,2410914,3355,2414269,114374,7
Arctic,2410795,1713220,4124015,50878,4
Welcome to Marwen,10763520,2297971,13061491,2354205,1911
"My People, My Country",2356683,447708310,450064993,876001,67
Promare,2313596,7151775,9465371,109085,54
Super 30,2269878,22431759,24701637,871256,317
Faustina: Love and Mercy,2243180,1255707,3498887,0,0
Gone with the Wind,2176120,0,2176120,1089932,717
3 from Hell,2172949,122876,2295825,0,0
Total Dhamaal,2167632,24744363,26911995,989387,202
Housefull 4,2109160,2516321,4625481,904808,315
Shoplifters,3313513,64685822,67999335,89264,5
The Wizard of Oz,2076020,21494,2097514,1195606,681
Luce,2010613,257591,2268204,132987,5
Chhichhore,2004400,1302950,3307350,614335,195
Official Secrets,1988546,7485057,9473603,64965,4
Better Days,1921657,223529300,225450957,989536,70
Badla,1861000,1729894,3590894,596446,50
The White Crow,1828784,5793811,7622595,78782,5
Ben Is Back,3703184,6431020,10134204,80734,4
Pandas,7574012,61766,7635778,158915,33
The Other Side of Heaven 2: Fire of Faith,1807216,0,1807216,454257,205
Ip Man 4: The Finale,3956031,171739350,175695381,737718,70
Wild Rose,1635117,5488332,7123449,52938,4
The Aftermath,1618497,7597094,9215591,56419,5
Made for More,2999134,0,2999134,0,0
Red Joan,1579730,9067763,10647493,38949,4
After the Wedding,1574258,1215761,2790019,50264,5
Extreme Job,1565885,118366848,119932733,42587,2
Waves,1658790,743995,2402785,134333,4
Qué León,2607916,5200000,7807916,291936,34
Capernaum,1661096,62752082,64413178,24988,3
The Kid,1508593,44890,1553483,514286,268
Kinky Boots: The Musical,900451,1735120,2635571,386612,455
Destroyer,1533324,4047616,5580940,55347,3
The Wife,9601092,10377097,19978189,108284,4
El Chicano,1400603,4043,1404646,700261,605
Fantastic Fungi,1788322,75987,1864309,9419,1
1917,159227644,215489801,374717445,576216,11
Spirited Away,1322927,0,1322927,561821,765
Never Look Away,1304042,3801402,5105444,0,0
Pilgrim's Progress,1294596,1878686,3173282,678647,706
Can You Ever Forgive Me?,8803865,3638296,12442161,161510,5
Asterix: The Secret of the Magic Potion,1271953,44949251,46221204,193040,51
Metallica & San Francisco Symphony - S&M2,1252385,1330462,2582847,144736,157
BTS World Tour 'Love Yourself: Speak Yourself' (The Final) Seoul Live Viewing,1226552,0,1226552,1226552,490
High Life,1225852,907181,2133033,99341,4
All Is True,1200481,1818662,3019143,44211,4
Kingdom Men Rising,1188936,0,1188936,0,0
Los Domirriqueños 2,1187280,0,1187280,341847,53
Ek Ladki Ko Dekha Toh Aisa Laga,1182636,2349201,3531837,606775,193
No Safe Spaces,1291514,0,1291514,45236,1
Nothing to Lose 2,1150551,15460162,16610713,606934,97
Western Stars,1581681,2100000,3681681,560282,345
Konosuba!: God's Blessing on This Wonderful World! - Legend of Crimson,1134786,3944156,5078942,0,0
My Neighbor Totoro,1105564,139,1105703,484254,767
Playmobil: The Movie,1115008,15234295,16349303,656530,2337
Mortal Engines,15951040,67721633,83672673,7559850,3103
Bennett's War,1056416,0,1056416,430898,970
Princess Mononoke,1046446,0,1046446,417311,752
Luka Chuppi,1042905,880681,1923586,485342,139
The Souvenir,1036737,682420,1719157,78400,4
Noah,1035603,0,1035603,392734,602
El Coyote,1101470,0,1101470,0,0
Perfect Strangers,1014507,32247859,33262366,422656,132
Marianne & Leonard: Words of Love,1012034,2259854,3271888,44942,4
Kiki's Delivery Service,1004057,0,1004057,352556,753
BlacKkKlansman,49275340,44125483,93400823,10845330,1512
Jesus Is King,973000,109629,1082629,830000,372
Rush: Cinema Strangiato 2019,960073,0,960073,2580,1
The Fighting Preacher,954641,0,954641,60223,28
Toni Morrison: The Pieces I Am,903018,24477,927495,48050,4
A Hidden Life,1730597,2883622,4614219,50383,5
Between Me and My Mind,875191,0,875191,14614,16
Howl's Moving Castle,865647,0,865647,368180,748
Pati Patni Aur Woh,874044,5838481,6712525,432145,130
Steel Magnolias,855421,0,855421,495528,689
Woman at War,847495,3627333,4474828,18370,5
Alien,833658,345186,1178844,386976,682
Climax,817339,1210052,2027391,119423,5
Transit,815290,191841,1007131,31931,2
One Piece: Stampede,1298528,80264213,81562741,357740,541
Chonda Pierce: Unashamed,787979,0,787979,0,0
Student of the Year 2,778566,857341,1635907,462108,190
The Church,772000,0,772000,272412,252
Patterns of Evidence: Moses Controversy,765361,0,765361,217327,855
I Love Lucy: A Colorized Celebration,754323,0,754323,0,0
Joni 75: A Birthday Celebration,752205,56626,808831,35111,59
The Game Changers,739711,158281,897992,0,0
David Crosby: Remember My Name,732793,0,732793,43483,4
More Than Blue,722669,142235495,142958164,185928,26
Honeyland,815082,356398,1171480,31381,2
Where's My Roy Cohn?,705274,17329,722603,41202,4
Non-Fiction,704919,2944123,3649042,29853,2
The Captain,706572,416246690,416953262,324769,47
Raise Hell: The Life & Times of Molly Ivins,694410,0,694410,94504,18
Spirits in the Forest,704744,1827041,2531785,232452,276
The Sky Is Pink,652592,436049,1088641,334713,194
Racetime,1875283,1563770,3439053,271061,86
Dirty Dancing,622968,0,622968,356515,650
American Masters: Miles Davis: Birth of the Cool,614201,370298,984499,18258,1
Roger Waters - Us + Them,611644,682836,1294480,251842,396
The Muppet Movie,610475,0,610475,0,0
The White Storm 2: Drug Lords,609461,188786919,189396380,244795,54
The Least of These: The Graham Staines Story,607015,88149,695164,282472,440
The Chaperone,600654,940569,1541223,12150,2
Furie,594788,5122852,5717640,156120,14
To Kill a Mockingbird,592237,0,592237,357549,668
Bethany Hamilton: Unstoppable,590671,93407,684078,241740,205
The Public,573503,71237,644740,259455,263
My Fair Lady,560711,0,560711,354764,652
Fiddler: A Miracle of Miracles,549386,9430,558816,36425,7
Everybody's Everything,547207,201332,748539,60582,29
"DCI 2019: Big, Loud & Live 16",546060,0,546060,0,0
La femme de mon frère,539524,1132445,1671969,59438,16
Grateful Dead Meet-Up 2019,537153,0,537153,3786,4
Code Geass: Lelouch of the Re;Surrection,522805,8192807,8715612,189617,479
Shadow,521396,91186978,91708374,27474,4
Long Day's Journey Into Night,521365,41619629,42140994,26746,3
The Spy Behind Home Plate,519525,0,519525,10250,1
Wild Nights with Emily,519487,0,519487,30209,3
Saving Private Ryan,508694,0,508694,265125,642
Birds of Passage,507259,2010146,2517405,23082,2
Tel Aviv on Fire,506145,1042748,1548893,47545,11
Widows,42402632,33582068,75984700,12361307,2803
Whisper of the Heart,498156,0,498156,0,0
Nausicaä of the Valley of the Wind,495770,0,495770,0,0
Crazy Rich Asians,174532921,64000000,238532921,26510140,3384
Batla House,493180,771157,1264337,212645,81
The Climbers,487157,156272010,156759167,156096,102
The Russian Five,485049,0,485049,156732,36
The Great Alaskan Race,485603,10462,496065,0,0
Exit,470699,69031073,69501772,32441,2
Lawrence of Arabia,482281,0,482281,291722,661
CatVideoFest,470923,65643,536566,11269,1
Panipat,461863,2888036,3349899,295624,175
Christmas Jars,459462,0,459462,0,0
Gorillaz: Reject False Icons,453687,21778,475465,0,0
Cruel Intentions,445218,0,445218,258708,708
Teen Spirit,441366,1132235,1573601,43620,4
At Eternity's Gate,2294915,8947689,11242604,92856,4
Merci pour tout,1073969,0,1073969,231908,57
Les Misérables: The Staged Concert,459478,4792164,5251642,192034,392
De De Pyaar De,425934,1047182,1473116,425934,104
Hail Satan?,424284,43077,467361,26496,3
Ben-Hur,422622,0,422622,241792,649
Killing Sarai,425332,0,425332,226670,160
Fate/stay night [Heaven's Feel] II. lost butterfly,420595,16875269,17295864,0,0
Ash Is Purest White,422814,11390695,11813509,45150,7
The Cold Blue,420177,0,420177,0,0
The Reliant,408747,0,408747,0,0
The Invisibles,407373,356877,764250,27164,4
Monos,406473,1187722,1594195,49843,5
Meet Me in St. Louis,403521,0,403521,225684,679
"Hello, Dolly!",400881,0,400881,221204,669
The Nightingale,400209,485707,885916,35882,2
Mia and the White Lion,399471,35087719,35487190,192816,312
The Man Who Killed Don Quixote,391963,1998420,2390383,0,0
The Wedding Guest,386166,0,386166,18266,4
The Secret World of Arrietty,384289,0,384289,226728,741
What We Left Behind: Star Trek DS9,382457,51980,434437,0,0
The Cure: Anniversary 1978-2018 Live in Hyde Park,378405,213499,591904,38761,83
The Hummingbird Project,371784,505196,876980,34202,4
Ghostbusters,369612,60823,430435,239202,546
Matthias & Maxime,374739,1355516,1730255,64988,50
The Shawshank Redemption,358507,28588,387095,183128,669
The Tomorrow Man,354103,0,354103,18281,4
Star Trek: The Motion Picture,346243,0,346243,220007,627
Photograph,344534,651637,996171,35796,13
Diane,336166,0,336166,24467,3
Millennium Actress,225250,0,225250,0,0
A Silent Voice: The Movie,333984,0,333984,0,0
The Big Fight Live: IBF Welterweight Title: Errol Spence Jr. vs. Mikey Garcia,328979,0,328979,328979,288
P Storm,326711,117665016,117991727,104071,30
Fleabag,326283,6245816,6572099,0,0
Sword of Trust,322421,948,323369,19332,2
Lucy in the Sky,319976,5974,325950,54058,37
You Are Here: A Come From Away Story,318885,0,318885,0,0
Josh Groban Bridges Live from Madison Square Garden,315173,0,315173,0,0
Bolshoi Ballet: The Sleeping Beauty,311368,295504,606872,311368,355
DanTDM Presents The Contest,307484,457879,765363,307484,684
K-12,303230,56147,359377,0,0
Aquarela,307346,331561,638907,24753,5
Ask Dr. Ruth,297195,21035,318230,93128,104
Line Walker 2: Invisible Spy,296751,99185276,99482027,96991,17
Junglee,295784,3737803,4033587,47089,70
The Giant Spider Invasion,293053,0,293053,0,0
Stockholm,292590,372937,665527,0,0
The Godfather: Part II,291754,0,291754,171417,681
Killerman,291477,322889,614366,153799,322
The Bravest,290217,244889345,245179562,110375,150
Saga of Tanya the Evil - The Movie,288460,0,288460,0,0
Khalid: Free Spirit,284229,0,284229,0,0
Mike Wallace Is Here,281245,0,281245,19437,3
The Whistleblower,280851,7224290,7505141,150481,133
Octaman,280710,0,280710,0,0
The Nutcracker and the Four Realms,54858851,119102218,173961069,20352491,3766
I Want to Eat Your Pancreas,277019,33470987,33748006,111108,397
Freaks,276591,65674,342265,161543,111
True Grit,276418,0,276418,157788,614
The Tale of The Princess Kaguya,271681,0,271681,0,0
Shakira in Concert: El Dorado World Tour,271586,23091,294677,111273,398
Is It Wrong to Try to Pick Up Girls in a Dungeon - Arrow of the Orion,271489,67143,338632,0,0
One Child Nation,270128,1713,271841,20523,2
Just Mercy,36001502,14400000,50401502,107858,4
Slayer: The Repentless Killogy,268727,4147,272874,0,0
Luzia: Cirque du Soleil in Cinema,265673,0,265673,0,0
Out of Liberty,265279,0,265279,66546,35
Modest Heroes,178027,0,178027,178027,370
Smallfoot,83240103,130800000,214040103,23045635,4131
Star Raiders: The Adventures of Saber Raine,260234,0,260234,0,0
Mobile Suit Gundam Narrative,259224,5867035,6126259,0,0
Her Smell,255599,4882,260481,36941,3
Lords of Chaos,253184,112169,365353,27649,4
Bolshoi Ballet: The Nutcracker,252935,1095313,1348248,252935,401
When Harry Met Sally...,252320,0,252320,157660,660
I Got the Hook Up 2,252293,0,252293,149036,37
Canal Street,251917,0,251917,108259,73
Meeting Gorbachev,251837,67393,319230,18128,2
The Twilight Zone: A 60th Anniversary Celebration,248514,0,248514,0,0
Doctor Who: The End of Time: Part One,247798,0,247798,0,0
Friendsgiving Day #1,246168,0,246168,246168,766
63 Up,483684,0,483684,13956,1
311 Enlarged to Show Detail 3,238791,0,238791,0,0
Give Me Liberty,242734,381711,624445,33261,3
American Woman,236637,8779,245416,110552,117
Romeo Akbar Walter,236299,452420,688719,142102,101
Premier Boxing Champions: PBC on FOX: Spence vs. Porter,232973,0,232973,232973,239
DAZN Boxing: Canelo Alvarez vs. Daniel Jacobs,230703,0,230703,230703,426
Under the Sea 3D,36262926,19639698,55902624,661185,49
Mine 9,226421,0,226421,68921,23
Premier Boxing Champions: PBC on FOX PPV: Pacquiao vs. Thurman,223858,0,223858,223858,194
Never Surrender: A Galaxy Quest Documentary,222971,0,222971,0,0
First Love,218329,118427,336756,21151,2
"The Gangster, the Cop, the Devil",216494,25558877,25775371,78655,21
The Karate Kid,215447,0,215447,140623,588
The Possession of Hannah Grace,14837422,28179106,43016528,6401744,2065
Hamlet,214578,0,214578,0,0
"Faith, Hope & Love",210091,0,210091,55403,18
Master Z: The Ip Man Legacy,209454,21623195,21832649,92663,61
Kathy Griffin: A Hell of a Story,208907,0,208907,0,0
Play the Flute,241251,0,241251,0,0
Bolshoi Ballet: Carmen Suite/Petrushka,207523,314656,522179,207523,362
The Iron Orchard,204881,0,204881,45863,8
Hesburgh,204709,0,204709,17009,2
Venom,213515506,642569645,856085151,80255756,4250
Forrest Gump,203088,4937740,5140828,114767,560
Dabangg 3,202000,14582628,14784628,0,0
Blink of an Eye,201874,0,201874,0,0
Friendsgiving Day #2,198869,0,198869,0,(
Chasing the Dragon II: Wild Wild Bunch,196634,45536722,45733356,60971,16
Family,194601,0,194601,19586,3
A Beautiful Planet,15650615,10079505,25730120,223983,137
Heading Home: The Tale of Team Israel,207533,0,207533,12678,1
Bolshoi Ballet: Le Corsaire,190192,226960,417152,190192,383
The Divine Plan,190031,0,190031,0,0
Pagalpanti,423340,5210293,5633633,227714,116
Mr. Klein,193028,0,193028,15915,1
42nd Street: The Musical,187440,1798017,1985457,0,0
The River and the Wall,183602,0,183602,57504,57
To Dust,184495,0,184495,8496,1
Giant Little Ones,181507,0,181507,13042,1
Raymonda: Bolshoi Ballet,181361,0,181361,181361,383
Bolshoi Ballet: Raymonda,181361,0,181361,181361,383
Robin Hood,30824628,55664403,86489031,9195670,2827
The Warrior Queen of Jhansi,177289,17252,194541,112208,276
India's Most Wanted,176858,58493,235351,98322,110
"Iyengar: The Man, Yoga, and the Student's Journey",176387,0,176387,9248,1
Tigers Are Not Afraid,175559,34579,210138,30710,6
Marjaavaan,174164,466990,641154,101761,65
Ashfall,372562,60883393,61255955,36201,2
Bolshoi Ballet: The Golden Age,171916,105750,277666,171916,360
Nureyev: Lifting the Curtain,165203,177052,342255,6362,5
Frankie,171781,523899,695680,19435,4
Indian Horse,2097362,0,2097362,0,0
Asbury Park: Riot Redemption Rock 'n Roll,167684,97299,264983,7437,205
The Bad Guys: The Movie,166972,33857414,34024386,45233,11
Bright Ones,165627,0,165627,165627,614
Sunset,164906,918393,1083299,13846,3
INXS: Baby Live at Wembly Stadium,161750,204675,366425,0,0
Monty Python's Life of Brian,161507,332464,493971,18005,47
"Diana Ross: Her Life, Love and Legacy",160968,0,160968,0,0
Batman,159419,48482,207901,159419,489
Them That Follow,159218,13734,172952,13137,3
Synonyms,206003,295220,501223,17891,2
The World Before Your Feet,268644,0,268644,22482,2
Money,155732,0,155732,0,0
The Death & Life of John F. Donovan,152713,3173651,3326364,33340,25
Halston,151991,11455,163446,11643,1
Peterloo,151971,1846974,1998945,26002,3
Before You Know It,151507,0,151507,23086,3
Jay Myself,151331,0,151331,18909,1
Glory,150801,0,150801,83347,435
The Samuel Project,161565,0,161565,11087,2
Little Woods,150010,21902,171912,57610,33
Trial by Fire,148504,0,148504,78817,109
War and Peace,148503,0,148503,22976,1
Dogman,148225,4931922,5080147,13013,3
Framing John DeLorean,145625,0,145625,6991,1
Hampstead,144396,6190775,6335171,17141,12
Doctor Who: Logopolis,143248,0,143248,0,0
Hubble 3D,52522904,21726825,74249729,413477,39
Canelo vs. Kovalev,140820,0,140820,140820,471
The Last Resort,158646,0,158646,1844,1
Wilder vs. Ortiz,139207,0,139207,139207,186
Who Will Write Our History,138039,829,138868,13390,1
Rafiki,137968,43348,181316,16016,26
Lynryd Skynyrd: Last of the Street Survivors Farewell Tour,137888,0,137888,0,0
The Other Story,135191,0,135191,14163,5
Okko's Inn,134787,158598,293385,763,1
Palau the Movie,134696,36459,171155,0,0
Burning,718991,6857354,7576345,26130,2
Made in Abyss: Journey's Dawn,134047,147,134194,0,0
Peppa Celebrates Chinese New Year,131225,18521815,18653040,66913,67
Mister America,130897,0,130897,10090,2
The Zoya Factor,128831,160800,289631,79517,100
Woodstock,126562,194048,320610,0,0
Paris Is Burning,125677,0,125677,10839,1
Lost & Found,125173,38853,164026,0,0
Mary Magdalene,124741,0,124741,46646,62
Easy Rider,123276,0,123276,74448,252
Born to Be Wild,25978556,15665919,41644475,871478,206
A Tuba to Cuba,121772,2820,124592,11270,2
Avant qu'on explose,119894,0,119894,28402,35
Portrait of a Lady on Fire,3759854,6162021,9921875,67344,2
The Fall of the American Empire,2178460,1932468,4110928,338216,72
"Ruben Brandt, Collector",117963,251846,369809,6036,1
The Reports on Sarah and Saleem,117479,489727,607206,10102,4
Mob Psycho 100,115766,0,115766,115766,375
Police Story,113164,0,113164,25591,5
Be Natural: The Untold Story of Alice Guy-Blaché,115685,18266,133951,3237,1
The Kingmaker,122587,26024,148611,19523,2
Babylon,109749,0,109749,21214,1
Branagh Theatre Live: The Winter's Tale,141143,0,141143,34380,92
The Audience,106529,416903,523432,0,0
The Brink,106057,0,106057,18063,4
"Belle and Sebastian, Friends for Life",105890,124093,229983,38017,38
Cold Case Hammarskjöld,104965,0,104965,18285,10
Downtown 81,122390,0,122390,25208,1
Miss & Mrs. Cops,104578,12042592,12147170,15073,2
Penguin Highway,104567,3902080,4006647,22833,84
Anthropocene: The Human Epoch,104806,229356,334162,16038,7
The Divine Fury,102982,11696574,11799556,43863,23
Walking on Water,102140,75979,178119,10654,2
Mojin: The Worm Valley,101516,22280067,22381583,50583,17
Wonders of the Sea,100780,178635,279415,0,0
Mirai,812794,26714167,27526961,63325,69
Tazza: One-Eyed Jack,97655,16474956,16572611,41139,22
The Third Wife,84933,220822,305755,3339,1
The Song of Names,1077584,61116,1138700,39452,10
The Image Book,94153,36649,130802,13854,33
Margaret Atwood: Live in Cinemas,93690,435595,529285,0,0
Rojo,94757,462335,557092,12479,2
Always Miss You,91884,18923581,19015465,46720,14
Mapplethorpe,91002,0,91002,17000,3
The Crossing,90896,1498316,1589212,40243,28
Loopers: The Caddie's Long Walk,90679,0,90679,28253,68
My Dear Liar,90545,31087423,31177968,36787,29
A Bigger Splash,95826,0,95826,18000,1
Sound! Euphonium the Movie - Our Promise: A Brand New Day,90341,2312689,2403030,0,0
Varda by Agnès,160765,74934,235699,12390,2
Take Point,112386,12795646,12908032,21189,2
Ramen Shop,88455,646553,735008,5303,2
The Lumber Baron,88336,0,88336,15059,11
Jim Allison: Breakthrough,87984,0,87984,8679,3
ECCO,86858,0,86858,48205,155
Sonchiriya,86765,48648,135413,60170,70
The Chambermaid,86422,78109,164531,5490,1
National Theater Live: Cyrano de Bergerac,86300,1087212,1173512,0,0
Mayday Life,85912,7349584,7435496,47769,8
Skid Row Marathon,84997,0,84997,84997,438
Papi Chulo,84703,9618,94321,7257,2
Woodstock,84440,0,84440,8150,2
Once Upon a Deadpool,6100309,45147259,51247568,2683200,1566
Looking Up,84267,122910316,122994583,36541,13
High Strung Free Dance,83891,14590,98481,54601,106
Ms. Purple,80657,0,80657,15734,1
The Old Man & the Gun,11277120,6583277,17860397,142131,5
Swing Kids,222001,10175407,10397408,43952,15
Saint Judy,78935,17277,96212,39275,55
The Heiresses,78473,732723,811196,11304,2
A Faithful Man,77491,1643114,1720605,7321,1
Ploey,77815,6068477,6146292,0,0
Fast Colour,76916,0,76916,37594,25
Christ Stopped at Eboli,78736,0,78736,9006,1
Triple Threat,76289,269611,345900,5936,12
"Hale County This Morning, This Evening",112282,0,112282,8640,2
Savage,74491,4066011,4140502,36590,19
5B,72968,0,72968,38314,128
Working Woman,64048,140679,204727,3875,2
Cliffs of Freedom,72476,228366,300842,16350,6
3 Faces,72324,2119192,2191516,7065,1
Storm Boy,71760,4209458,4281218,46676,56
Free Trip to Egypt,71087,0,71087,0,0
The Battle of Jangsari,70853,7812347,7883200,8552,2
Styx,70794,47394,118188,3420,1
Batman Returns,70642,10057,80699,80000000,0
Edie,71790,2659380,2731170,8801,7
Diamantino,70088,164953,235041,6412,1
The Body,68196,91121,159317,45996,78
The Silence of Others,67986,221469,289455,7868,1
The Divine Move 2: The Wrathful,67578,15575413,15642991,12269,2
Being Frank,67343,0,67343,16392,3
Cunningham,265102,55191,320293,18422,4
This Changes Everything,64988,60360,125348,0,0
End of the Century,66309,13298,79607,10063,1
Beautiful Boy,7649973,8986631,16636604,218888,4
Sauvage / Wild,61604,255932,317536,7440,1
The Mountain,61035,0,61035,15785,2
Last Year at Marienbad,63425,4977,68402,7644,1
By the Grace of God,67059,7688593,7755652,7765,2
John Fogerty: 50 Year Trip - Live at Red Rocks,59795,0,59795,0,0
Mickey and the Bear,57188,0,57188,9375,1
Heavy Water,55446,44057,99503,0,0
Maria By Callas,1267301,918261,2185562,91915,16
The Hate U Give,29719483,5214526,34934009,512035,36
Plácido Domingo Gala,52502,258744,311246,52502,217
One Cut of the Dead,52406,27537774,27590180,6360,2
QT8: The First Eight,51896,49720,101616,0,0
Greener Grass,51456,24589,76045,9305,2
"Cyrano, My Love",351019,5634803,5985822,0,0
Making Waves: The Art of Cinematic Sound,53144,10854,63998,12348,3
Ophelia,50722,178683,229405,22145,58
Clinton Road,50400,0,50400,38880,10
"Love, Antosha",50168,12732,62900,7150,1
Free Trip to Egypt,49693,0,49693,1718,1
The Bounty Killer,48815,0,48815,20805,15
The Final Wish,25183,70032,95215,0,0
The Queen,47818,0,47818,7173,1
Becoming Astrid,120486,818280,938766,5361,3
Under the Silver Lake,46083,2007386,2053469,35270,2
Sympathy for the Devil,51150,63151,114301,12144,6
¡He matado a mi marido!,45777,22240,68017,18365,11
High on the Hog,45696,0,45696,15125,5
The Proposal,45149,0,45149,10449,1
What Is Democracy?,44536,0,44536,6284,1
Maze,44381,0,44381,8308,2
American Dharma,51891,0,51891,7287,1
Carmine Street Guitars,44253,0,44253,6090,1
The Star,43510,21459185,21502695,43510,623
Fagara,43417,1222532,1265949,25206,13
Immortal Hero,43007,6137025,6180032,20629,12
Vita & Virginia,42741,750698,793439,3408,1
For Sama,43796,1352800,1396596,9350,3
Midnight Traveler,41265,9071,50336,3549,1
Clemency,364716,0,364716,35444,2
Charlie Says,40685,57555,98240,20684,38
Slut in a Good Way,40513,3727,44240,21567,7
Aniara,40124,0,40124,19297,19
Zilla and Zoe,39003,0,39003,11392,4
Shed of the Dead,38901,0,38901,18960,10
The Raft,39678,7591,47269,0,0
The Cave,62625,196296,258921,21185,2
Batman Forever,38014,373,38387,38014,434
Union,41656,0,41656,11900,4
The Quiet One,37010,0,37010,7695,6
The Death of Dick Long,36856,0,36856,26630,30
Britt-Marie Was Here,36549,132313,168862,4090,3
The Sower,36233,396879,433112,4128,2
Buñuel in the Labyrinth of the Turtles,36205,149470,185675,5691,2
Yardie,36012,1515151,1551163,22056,77
Loro,35613,0,35613,5317,1
White Snake,34730,61597046,61631776,2791,1
Love Live! Sunshine!! The School Idol Movie: Over The Rainbow,34135,7698913,7733048,0,0
The Wild Pear Tree,34014,1662244,1696258,4923,1
Killer Unicorn,33901,0,33901,15515,5
Moonlight Sonata: Deafness in Three Movements,33823,0,33823,5424,1
An Elephant Sitting Still,32556,7043,39599,10854,1
Knife + Heart,32516,309331,341847,4728,2
An Acceptable Loss,32427,0,32427,3447,1
10E,32413,0,32413,28863,2
Ága,35178,0,35178,2553,1
Desolation Center,32016,0,32016,4938,3
Gift,31588,0,31588,4255,2
Buddy,31203,0,31203,0,0
Horn from the Heart: The Paul Butterfield Story,58597,0,58597,3086,1
Pasolini,30757,0,30757,8362,1
Space Station 3D,93383953,34979928,128363881,489488,24
Sorry Angel,30628,1605645,1636273,6559,1
Los Reyes,30418,0,30418,5661,2
The Nun,30245,2414,32659,6273,1
Deep Sea,46412757,51818148,98230905,700213,43
Lionel Richie at Glastonbury,30123,0,30123,0,0
The Ground Beneath My Feet,29251,0,29251,3295,1
Vault,29491,57250,86741,0,0
Recorder: The Marion Stokes Project,55632,0,55632,8216,1
Batman & Robin,28597,196,28793,125000000,0
In the Aisles,28394,666192,694586,922,1
Hotel by the River,28354,73525,101879,5534,1
The Wind,28252,102722,130974,14138,30
The Load,28410,0,28410,4094,1
El Norte,27920,0,27920,27920,179
Kind Hearts and Coronets,35948,44847,80795,8004,1
"Leaving Home, Coming Home: A Portrait of Robert Frank",27073,0,27073,4248,1
The Day Shall Come,26972,517021,543993,14854,30
Memory: The Origins of Alien,31378,5894,37272,14704,19
Wrestle,26597,0,26597,6027,1
Donnybrook,26284,0,26284,9802,80
Neither Wolf Nor Dog,589289,0,589289,0,0
Asako I & II,25559,601543,627102,5690,2
Return of the Hero,37108,7325622,7362730,761,1
Invisible Life,146535,1619714,1766249,8127,2
Chasing Einstein,24057,0,24057,9708,4
Vox Lux,727119,712420,1439539,155714,6
Piranhas,23494,2275031,2298525,2898,1
Wildlife,1050616,2270751,3321367,104589,4
Celebration,22557,22341,44898,5034,1
Night School,77339130,25766748,103105878,27257615,3010
Hyenas,24672,0,24672,0,0
Light from Light,24808,0,24808,4719,2
Island of Lemurs: Madagascar,11272213,2794321,14066534,188307,37
Jane and Emma,380030,0,380030,84512,21
Wicked Witches,21600,0,21600,21600,10
The Hole in the Ground,21072,3352402,3373474,0,0
Redoubt,33155,0,33155,5253,1
The Gospel of Eureka,20039,0,20039,3517,1
The All Americans,20324,0,20324,7805,3
Light of My Life,20056,553734,573790,9358,28
General Magic,20046,0,20046,2267,5
The Sound of Silence,20013,1981,21994,5449,2
Prassthanam,19984,77220,97204,12737,32
The Perfect Race,29644,0,29644,3400,1
Armstrong,19740,60429,80169,3071,12
Girls of the Sun,19712,149059,168771,7801,8
Out of Blue,18779,224068,242847,11719,35
Black Mother,18762,7157,25919,0,0
Before Stonewall,18724,0,18724,4588,1
The Return of Martin Guerre,18603,0,18603,8682,2
Midnight Diner,18555,3394216,3412771,10861,13
"Phoenix, Oregon",18356,0,18356,2981,1
The Cranes Are Flying,17923,0,17923,0,0
The House That Jack Built,87993,2180969,2268962,34273,32
Citizen K,120411,25530,145941,10571,1
Ode to Joy,17303,5291,22594,3568,2
Scandalous: The True Story of the National Enquirer,18759,0,18759,10837,12
Joseph Pulitzer: Voice of the People,16970,0,16970,5686,1
Ballon,34222,11765369,11799591,0,0
Too Late to Die Young,16591,7896,24487,6196,1
Tremors,23911,97902,121813,3340,4
Chained for Life,17431,0,17431,7415,2
Three Peaks,16216,6853,23069,1419,1
Virginia Minnesota,16118,0,16118,3844,2
Piercing,15856,133355,149211,8752,18
Starfish,15849,0,15849,0,0
Little Joe,23862,173098,196960,10626,12
To the Arctic 3D,14560838,9134550,23695388,270228,50
A Private War,1633208,2281999,3915207,60491,4
Airpocalypse,105678,18385411,18491089,35363,21
Trinity Seven The Movie 2: Heavens Library & Crimson Lord,15712,0,15712,14853,18
Midnight Family,42310,9402,51712,3030,1
Galapagos,18630372,10718800,29349172,0,0
Funan,15152,0,15152,1871,1
El Angel,109608,5495072,5604680,23348,2
Wrinkles the Clown,14938,0,14938,28248,21
ZZ Top: That Little Ol' Band from Texas,14879,0,14879,0,0
Frank and Ava,18829,0,18829,3080,1
Our Time,14777,27330,42107,3000,1
The Competition,15622,0,15622,0,0
Boy Erased,6788692,5064389,11853081,207057,5
Combat Obscura,14242,0,14242,10112,10
Screwball,13967,0,13967,8595,13
Touch Me Not,13782,61725,75507,5616,1
My Son,14450,0,14450,4750,3
This One's for the Ladies,13688,0,13688,13688,1
First Man,44936545,60760870,105697415,16006065,3640
The Cat Rescuers,31540,0,31540,4252,3
The House with a Clock in Its Walls,68549695,62907452,131457147,26608020,3592
Rapid Response,13294,0,13294,4497,8
Hagazussa,13253,8234,21487,6041,11
The Woman Who Loves Giraffes,113858,0,113858,1810,2
Off Season,12544,0,12544,2536,2
The White Sheik,50850,18090,68940,5562,1
Journey to the South Pacific,7653913,7340963,14994876,8137,1
Bricked,12201,0,12201,0,0
Zen for Nothing,12107,0,12107,1268,2
Imprisoned,12050,0,12050,4381,1
Quartet,12042,0,12042,5150,1
"Cassandro, The Exotico!",11897,0,11897,2269,1
Liyana,44045,0,44045,2160,1
The Charmer,26167,80212,106379,4128,1
The Disappearance of My Mother,24951,58979,83930,0,0
Stuffed,15532,0,15532,1602,1
Vision Portraits,10771,0,10771,0,0
That Part Feeling - the Universe of Arvo Part,8812,0,8812,0,0
Between the Lines,15383,0,15383,0,0
Yomeddine,11308,69722,81030,4013,4
In Like Flynn,11255,0,11255,6646,27
Made Me Do It,11151,0,11151,3842,2
Ferrante Fever,11137,3381,14518,3509,1
I Do Not Care If We Go Down in History as Barbarians,11307,27864,39171,2083,1
Suburban Birds,10997,0,10997,3207,1
16 Bars,10985,0,10985,2662,1
If the Dancer Dances,10912,0,10912,5000,1
Duet for Cannibals,12962,0,12962,0,0
Shooting the Mafia,10881,21161,32042,3251,2
Angels Are Made Of Light,7919,0,7919,1707,1
Daughter of Mine,10628,368382,379010,5447,2
The Eyes of Orson Welles,10253,58075,68328,2372,1
Round of Your Life,20941,0,20941,4336,4
Around India with a Movie Camera,10389,1179,11568,183,1
Olivia,9934,0,9934,3948,3
Streetwise,9904,0,9904,5006,1
Tyrel,21456,0,21456,6059,5
Fritz Lang's Indian Epic,9345,0,9345,4401,1
The Spanish Prisoner,9589,0,9589,2679,1
Studio 54,199767,27295,227062,14909,1
When Lambs Become Lions,9337,860,10197,3155,1
Cracked Up,9197,0,9197,5310,1
Frantz Fanon: Black Skin White Mask,9025,0,9025,3278,1
Colossal Youth,8331,637,8968,0,0
The Dead Center,8320,0,8320,5325,10
The Etruscan Smile,8213,0,8213,6729,4
Grass,8084,45419,53503,2774,1
Wings of Desire,123830,0,123830,12885,1
This Magnificent Cake!,7888,0,7888,991,1
Ghost Fleet,7850,0,7850,0,0
The Plagiarists,7768,0,7768,4577,1
Gregory's Girl,7710,0,7710,4185,1
I'll Take Your Dead,7692,0,7692,1963,4
King of Thieves,7518,11345997,11353515,3502,11
Life and Nothing More,24358,16223,40581,6536,6
Border,771930,1405748,2177678,73700,7
Beloved Beast,7301,0,7301,3894,3
Rosie,6839,97207,104046,2942,2
Genesis,6784,7072,13856,2585,1
Going Attractions: The Definitive Story of the Movie Palace,6763,0,6763,803,0
Dying to Survive,6752,0,6752,3238,2
Hollywould,11888,0,11888,5290,2
"One Nation, One King",6576,2475105,2481681,595,1
"Monrovia, Indiana",63944,652,64596,5172,1
Of Fathers and Sons,12579,0,12579,340,1
Under the Eiffel Tower,6291,0,6291,3957,11
Patrick the Pug,6290,3363178,3369468,1378,10
To Be of Service,6173,0,6173,1904,1
The Golden Glove,6160,598319,604479,2300,5
Relaxer,6133,0,6133,0,0
The Hottest August,9163,0,9163,3883,2
Kedarnath,901131,637286,1538417,407118,113
The Meanest Man in Texas,8850,0,8850,5750,3
Love Goes Public,5700,0,5700,5700,0
Série noire,5633,0,5633,2088,1
The Miracle of the Little Prince,5553,0,5553,2643,1
Halloween,159342015,96143163,255485178,76221545,3928
Spiral Farm,6517,0,6517,5475,3
Anna and the Apocalypse,545597,124833,670430,52588,5
Chokehold,5200,0,5200,5200,3
Body at Brighton Rock,5123,0,5123,1732,8
Intuitions,10606,0,10606,3407,3
Cold Blood,5083,1004805,1009888,3450,25
Chulas Fronteras,5021,0,5021,3548,1
The Garden,5006,0,5006,1141,1
Malek,4898,0,4898,2226,3
Un traductor,13509,64566,78075,4412,1
Crepitus,4846,0,4846,1790,1
Ballet Blanc,4832,0,4832,1894,2
Kaili Blues,32164,903072,935236,4164,1
What You Gonna Do When the World's on Fire?,4672,39618,44290,0,0
Slaughterhouse Rulez,4665,726097,730762,2145,10
Sicilian Ghost Story,15285,189607,204892,4324,1
At War,4605,2230447,2235052,1405,1
I'm Leaving Now,4488,0,4488,1255,1
SGT. Will Gardner,4405,0,4405,0,0
Tito and the Birds,4332,0,4332,0,0
The Fate of Lee Khan,4295,0,4295,1648,1
State Like Sleep,4282,0,4282,2813,10
The Gliksmans,5166,0,5166,2922,3
La Flor,4032,0,4032,2308,1
Mother of a Day,3919,0,3919,2672,1
Crown Vic,3868,0,3868,2468,1
Wallflower,3801,0,3801,2378,1
The Wandering Soap Opera,3624,0,3624,512,1
Rottentail,3383,0,3383,2256,3
Another Day of Life,3190,131611,134801,1691,2
Bauhaus Spirit: 100 Years of Bauhaus,17122,10646,27768,0,0
A Cool Fish,551876,117601259,118153135,71187,15
Chasing Portraits,3076,0,3076,1708,1
Filmworker,102609,10219,112828,7984,1
100 Acres of Hell,5152,0,5152,997,1
The Kindness of Strangers,2705,80337,83042,839,3
Back to the Fatherland,2697,0,2697,1312,1
L'héritage de la chouette,12316,0,12316,0,0
"No Date, No Signature",36444,70924,107368,4993,3
Joan the Maid 1: The Battles,2562,0,2562,1229,1
Chef Flynn,68407,1135,69542,7509,1
TINY: The Life of Erin Blackwell,2465,0,2465,1631,1
I Lost Albert,2354,0,2354,2354,1
Tea With the Dames,889343,2291809,3181152,14777,1
Iceman,2138,4581,6719,1372,7
Detour,16172,0,16172,5127,1
Jihadists,2104,0,2104,824,1
Divide and Conquer,38510,0,38510,18833,15
A German Youth,2343,0,2343,416,1
A Fish in the Bathtub,1237,0,1237,1237,3
Division 19,1699,981,2680,0,0
Little Q,1652,16358581,16360233,1652,1
Game Day,1624,0,1624,1624,4
For Those Who Don't Read Me,36506,0,36506,9263,5
American Playhouse: The Killing Floor,1583,0,1583,1583,1
Indivisible,3511417,78216,3589633,1503101,830
Owaranai hito: Miyazaki Hayao,187320,0,187320,10238,4
The Hours and Times,1273,0,1273,1273,1
Chinese Portrait,4140,0,4140,546,1
Narcissister Organ Player,15334,0,15334,1983,1
The Untold Story,790,0,790,790,1
Senso,27723,0,27723,3984,1
Serendipity,2298,0,2298,1156,2
Swimming with Men,24708,1353040,1377748,10336,31
Sgt. Stubby: An American Hero,4015935,916759,4932694,1164403,1633
I Am Not A Witch,50868,131594,182462,8252,2
A Breath Away,77987,2764053,2842040,16046,12
In Safe Hands,1737,7084859,7086596,348,1
Henchmen,1469,0,1469,580,3
1945,1006193,234470,1240663,20365,2
Tall Tales from the Magical Garden of Antoon Krings,220,12353629,12353849,0,0
Over the Limit,3243,0,3243,1402,1
Postcards from London,5312,10236,15548,2686,1
